Rogue|a person without principles; a dishonest individual|Although the rogue was engaged to be married, he found it easy to flirt with other women.|
Roguish|dishonest and deceitful, unprincipled and untrustworthy|The roguish thief conned an old lady into giving him access to her life savings.|
Roguishly|in the manner of a dishonest person or rogue|The cheating husband stared roguishly at every woman in the bar.|
Roil|to stir someone up, causing them to be angry or agitated|The man’s hateful speech was just enough to roil up the already uneasy crowd.|
Roister|to engage in noisy, drunken, or riotous behavior|The man began to roister loudly after every touchdown.|
Role|an actor or actress’s part in a play or movie|The actress’s role in the horror film was that of a killer nurse who preyed on sick patients.|
Rollicking|joyous and carefree|Debra’s book is a rollicking good read that will take your mind on a joyride like none other.|
Romantic|behavior or items that represent a sign of love and/or affection|Sending a romantic letter to his crush was the guy’s latest effort to gain the woman’s heart.|
Romanticism|a way of thinking or describing things makes them sound more exciting than they really are|Because he is such a realistic person, George doesn’t understand his wife’s romanticism.|
Romp|to play in an excited and energetic way|Our playful pups romp and frolic around the yard every time we take them outside.|
Rookery|a gathering or settlement of fowl or other animals|Clustered together on a small island in the ocean barked a rookery of seals making so much noise as the beachgoers passed by on the shore.|
Rookie|a beginner of a team or job|All of the fans groaned when the rookie of the team came up to bat because they knew he did not have the experience to hit a homerun.|
Roomer|a person who rents a room in another person’s home|The roomer was evicted from her landlord’s house after she refused to pay her part of the utilities.|
Roommate|a person who occupies the same house or apartment as someone else|My roommate is looking for a new place to live since we constantly argue over the apartment we share.|
Roost|where animals gather at night to sleep or rest, similar to nesting|The bats roost in the dark corner of an abandoned barn.|
Root|the basic cause or source of something|The therapist helped her client get to the root of her emotional issues and heal once and for all.|
Rope|a cord or cable made from natural fiber|The mountain climber attached a rope to the side of the cliff and used the cable to lift himself up.|
Rose|moved from a lower to a higher position|The student rose from his seat and went to the board to solve the math equation.|
Roseate|too optimistic; unrealistic|The hopeful girl’s attitude towards life was too roseate for her realistic mother’s tastes.|
Roster|a list of people's names, often with including the jobs they have been assigned|A new student was added to the teacher’s roster, causing her to be short one desk.|
Rostrum|a raised platform on which public speakers stand to address an audience; podium|The set designers built a rostrum for the choir members to stand on.|
Rot|to decay and deteriorate|After several days in the fridge, the perishable products started to rot and smell.|
Rotary|of motion revolving around a center or axis; rotational|Before the invention of cordless phones, telephones were rotary and in order to make a call, individuals had to press the number, spin it around, to get to the next number.|
Rotate|to spin around from the center|The Earth does rotate on its axis near the sun so that each part of the Earth gets daylight and night.|
Rote|without thought; by habit or routine|By singing the alphabet song throughout the day, my daughter is learning her letters by rote.|
Rotten|something that has decayed or deteriorated and is no longer fresh|The rotten fruit sitting in the garden began to stink and attract flies.|
Rotund|rounded in figure, plump, fat|The jovial man’s rotund belly bounced wildly as he tried to jump rope with the kids.|
Rough|Having a surface that is irregular not smooth|Rough seas tossed the boat high in the area, causing it to sink.|
Roughly|violently and forcefully|The seizing plane shook roughly as it flew through an area of extreme turbulence.|
Roulette|a gambling game in which players bet on which compartment of a revolving wheel that a small ball will land in|As the ball spun around the roulette wheel, the gamblers bet on which number it would land in.|
Roundup|to gather people or animals together|When it was time to eat lunch, Mrs. Hall had to roundup all of the children and brought them into the school cafeteria.|
Rouse|to make excited or enraged|The presence of the minority police officers will rouse the racist group even further.|
Rout|a defeat of an individual, army, group, or team|After the dictator’s rout, the people finally had control of their country.|
Route|a course or path to take to get somewhere|After digging a 300-foot long trench, the water would travel down this route from the place where I first started digging and dumping it into the river.|
Routine|activities performed at fixed times for intervals|The teacher explained the classroom routine to students so they would know when it was time to go to lunch.|
Row|a straight line of something|Each row of corn was planted neatly in the field section by section.|
Rowdy|wild in a loud or typically obnoxious manner|The rowdy patrons at the bar were loud and especially irritating in their words, making the night less enjoyable for everyone present.|
Royalty|the status or power of a king or queen or his or her family|Because he is royalty, the queen is in charge of running the entire kingdom from her throne.|
RSVP|to reply to a social request|Since we had nothing to do next Friday night, we decided to RSVP to the party by calling our friends and letting them know we would be there.|
Rub|to massage or kneed something by moving one’s hand or an object back and forth|The massage tech moved her hands back and forth to rub out the tension in the man’s back.|
Rubbish|garbage|After trimming around the good part of the meat, the remainder of it was simply rubbish which I threw away.|
Rubble|the pieces that remain after a structure is destroyed|The hurricane turned several oceanfront homes into piles of rubble.|
Rube|an uneducated or uncultured person that is from a rural area|The city boy considers his country cousin an uncultured rube since he knows little about art or classical literature.|
Rubicon|a boundary that is crossed without being able to return|In my science fiction story, the young man crossed over the Rubicon into another dimension knowing that he will stay there forever.|
Rubicund|bearing skin that is pink or red in color|The sunburn made his face rubicund in appearance.|
Rubric|a set of guidelines used to grade an assignment|Sarah really needed a good grade in English in order to pass the course so she looked at the rubric before writing her next essay.|
Rucksack|a sturdy bag with straps that is worn on the back, usually by hikers or campers|After placing his rucksack on his back, the hiker prepared for his long march up the mountain.|
Ruckus|a commotion or disturbance|Due to the ruckus in the motel room next door, it woke my whole family up.|
Ruction|a loud fight or disturbance|The ruction in the cafeteria started when one student threw a lunch tray at another student.|
Rudder|a part of a ship or vehicle found underneath that is used to turn the vehicle from side to side|When the Titanic was raised into the air, the people in the lifeboats could see the rudder that was underneath the ship.|
Ruddy|having a wholesome red skin color that generally comes from being outdoors a lot|The pasty teenager got a ruddy tan after spending most of her summer on the soccer field.|
Rude|to be impolite or disrespectful|Since the child was spoiled throughout his life, his way of speaking to others always included his rude manners.|
Rudiment|the start or beginning of a concept or plan|My friend’s addiction to my chocolate cupcakes was the rudiment of my successful bakery.|
Rudimentary|basic; minimal|You need to have at least a rudimentary understanding of technology before you can upload a video on that website.|
Rudiments|the simple skills or facts needed to begin or learn something|In French 101, students will learn the rudiments of the language.|
Rue|to experience regret or sorrow|My husband will rue the day he ever cheated on me!|
Rueful|displaying regret and/or sorrow for one’s actions|The rueful dog looked pitiful after it chewed up its blanket.|
Ruefully|in a way that expresses regret|The little boys ruefully apologized for breaking the window.|
Ruffian|a violent individual who more than likely engages in criminal activity|The ruffian became violently angry when the cashier refused to sell him alcohol.|
Ruffle|to annoy or upset someone or something|“I didn’t mean to ruffle your feathers when I told you that your dress looked ugly,” the teenager told her classmate.|
Rug|a small fabric mat used to cover part of the floor|“Wipe your feet on the rug,” the mother told her muddy son as he entered the foyer of their house.|
Rugged|describing a rough uneven area of land|Since there are so many rocks on the island, the terrain is extremely rugged.|
Ruin|to damage or wreck|Her face reddened when I seemed to ruin the young girl’s dress after accidentally spilling wine on it.|
Ruinous|causing ruin; destructive|The ruinous policies of our principal caused many of the students to leave the school.|
Rule|a law or regulation that tells what actions should or shouldn’t be done|Our state has put a law in place requiring everyone in a moving car to wear a seatbelt.|
Rumble|to roar or thunder|A rumble in the sky alerted the washerwoman that a storm was brewing.|
Ruminant|a type of animal with a four-chambered stomach hat brings up food from its stomach and chews it again|The water buffalo is a ruminant, which means it has a four-chambered stomach.|
Ruminate|to think deeply about something|Although I knew I cared deeply for Henry, I still had to ruminate on his marriage proposal for a while.|
Rumination|persistent and repetitive thinking|Constant rumination plagued the mind of the obsessive inventor who was unable to free himself from his thoughts.|
Rummage|to look for something by searching through the contents in an area|The dog will rummage through the garbage for food when it gets hungry.|
Rumor|gossip or a story that is circulating but not confirmed as true|Like junior high school girls, the gossiping women spread the malicious rumor all around the office tower.|
Rumor|a circulating story or tale that is probably not true|Allie was embarrassed by the nasty rumor and swore that she wasn’t dating two boys at the same time.|
Rumpus|a commotion or noisy disturbance|When the teacher began the class with a pop quiz over the difficult previous lesson, a rumpus among the students erupted throughout the room.|
Runaway|a person or thing that has run away from a place or situation|The runaway bride flew from the alter after becoming too afraid to marry her fiancé.|
Rung|struck a bell or an object with a bell|The schoolmaster rung the bell to let everyone know the class was ready to start.|
Runoff|an extra election or contest used to decide a winner when the first event failed to result in a clear victor|Since the vote was too close to count between two of the candidates, there will be a runoff next month.|
Runt|the smallest animal of a litter|The runt was the smallest, weakest, and cutest of the entire poodle puppy litter.|
Rupture|a crack that interrupts peaceable relations|The missile launch is sure to rupture the relationship between the two countries.|
Rural|areas that are not in an urban environment|My father and his friends often leave the city to go hunt game in rural areas.|
Ruse|a plan or plot to mislead someone|The security guard knew the girls were going to try and use a distractive ruse in order to shoplift.|
Rush|to move quickly usually due to being late or something urgent|Brad had to rush around the house looking for his uniform when he woke up late for school.|
Rust|corrosion or oxidation that occurs when certain types of metals get wet|Because the child left his bike in the rain, orange rust covered his metal chain.|
Rustic|having a country or simple style|The rustic cabin was filled with hand carved furniture.|
Rusticate|to suspend a student from a university as punishment|Ruling to rusticate the student, the college’s board of directors sent him home for cheating.|
Rustle|to move (something) with a soft crackling sound|It was a lovely fall day watching the leaves change color and rustle in the wind.|
Rustling|making light sounds because parts of something are touching each other|Rustling his change together in his hand, the boy thought long and hard about how he wanted to spend his coins.|
Rut|a habit or pattern that is hard to change|The prize-winning horse seemed to be a rut this year, having come in dead last during the past three races.|
Rutted|having deep grooves from wheels driving over something consistently|Rutted sections of the gravel track caused the bicyclist to flip his bike after hitting a dip in the road.|
Sabbath|a day set aside for religious observation including worship and rest|Many stores in the U.S. are closed on Sunday as the Sabbath day is regarded as a time for rest.|
Sabbatical|extended period of leave|The pastor’s sabbatical was related to his health issues.|
Saber|a long, heavy sword with a curved blade|An inseparable element of the ninja costume was the curved saber that was used to ward off enemies.|
Sable|a weasel-like mammal with warm fur that is often used to make clothing|The sable is best known for its soft pelt, making it a popular and valuable mammal for the fur industry.|
Sabotage|to deliberately damage or destroy something in order to prevent it from being successful|He felt his girlfriend would sabotage his efforts to succeed, leading him to break off the relationship.|
Saboteur|a person who practices sabotage|A saboteur was not needed since the political candidate’s constant scandals ruined his own campaigns.|
Saccharine|romantic or sentimental to the point of sounding silly |The foolish man at the bar thought he could pick me up with a saccharine line.|
Sack|a bag made from strong materials such as burlap that is used to carry goods|Reaching into the sack, the boy took out his lunch and began to eat the goodies his mother had packed.|
Sacrament|a formal religious rite or ceremony|According to the church, April can’t receive the communion sacrament because she is a divorced woman.|
Sacred|holy; divine|If you disturb the god's sacred shrine, some people believe you will be instantly killed.|
Sacrifice|to give up something valuable to help someone else|I decided to sacrifice my illustrious career to raise my family.|
Sacrificial|relating to sacrifice|Giving up your umbrella for someone else is a sacrificial act.|
Sacrilege|the corruption of something considered holy|It is considered an act of sacrilege for anyone to touch the sacred statue.|
Sacrilegious|acting in a disrespectful manner towards something or someone considered to be holy|Burning the Bible is a sacrilegious act.|
Sacrosanct|too important or respected to be criticized or changed|Woodland Hills Cemetery is sacrosanct and cannot be moved to another plot of land because of the large number of deceased soldiers who are buried there.|
Saddened|very upset and depressed|Saddened by the loss of his mother, the young boy could do nothing other than cry.|
Sadder|filled with more sorrow or grief in comparison to someone, something else, or another time|Losing a loved one is always difficult, but I was much sadder the day by grandmother died than during any other loss.|
Saddle|a leather covered seat used to ride an animal|Placing a saddle on the horses back, the cowboy prepared for his long journey.|
Sadistic|delighting in or feeling pleasure from the pain of others|Doris feared being kidnapped by a sadistic maniac.|
Sadly|unfortunately and regrettably|I pretended to react sadly to the news of my husband’s departure, but I was really overjoyed.|
Sadness|being filled with sorrow or grief|None of the social worker’s college courses could prepare her for the deep sadness and grief experienced by the children being removed from their homes.|
Safari|a journey to see or hunt animals, especially in Africa|Animals of the African savannah were crowded out by tourists wanting to snap photos on safari.|
Safeguard|to take appropriate measures in order to protect something from harm|Washing your pillows and sheets in hot water can safeguard against a lice infestation.|
Safety|security or well-being|Because the hurricane poses a risk to their safety, the family has decided to evacuate.|
Sag|to droop down to a lower level|The sandcastle began to sag in the middle as water filled the top of the construction.|
Saga|a lengthy and complex sequence of experiences|The author’s second novel is the continuation of the saga she started in her first book.|
Sagacious|intelligent; showing good judgement|Wise and full of insight, the sagacious leader would live on to better the world.|
Sagacity|ability to make good judgments and decisions|While many people believed he was stupid, the politician’s sagacity allowed him to realize he would not be elected again.|
Sage|a wise individual who gives others helpful advice|The sage of the Indian tribe was able to heal the badly wounded man.|
Sail|to travel in a boat, especially one with material extended on a mast to catch the wind|With sails up and the wind blowing, the pirates prepared to sail their ship to their next destination.|
Sailor|one whose occupation is on board a ship at sea|The sailor asked to move to quarters on a different deck since he stayed seasick most of the time.|
Saint|a title given to someone regarded as holy and virtuous after his or her death|Believing that her prayer would be answered, the worshiper cried out to the departed saint for deliverance from her situation.|
Sake|done for a reason, explanation, or advantage|The mother sacrificed her livelihood and lifestyle by devoting all of her time and energy for the sake of her children.|
Salacious|promoting sexual desire or lust|The salacious content of some popular novels has led parents to demand that they be removed from school libraries.|
Salary|a determined yearly amount of money paid to an employee by an employer during a job|Before accepting the position at the law firm, I negotiated my salary to be $3,000 more.|
Salient|most important or prominent|When I look at the house for sale, salient defects such as the broken windows stare back at me.|
Saliva|wet liquid substance produced from glands in the mouth|Suspects in a crime are required to submit their DNA by having their saliva tested with cotton swabs.|
Sallow|having an unnatural yellowish or pale skin color|Since Jana spent the entire winter inside, her complexion was sallow and unnatural when she finally went outdoors.|
Sally|a quick attack|Knowing the home intruder would find me in the closet, I decided to spring a surprising sally upon him with any weapon I could find.|
Salon|a lovely room usually in the front part of a house used for welcoming and amusing visitors|After purchasing the mansion, the homeowners first decorated the salon since that is the place their friends would most likely be entertained.|
Salubrious|something that is good for you or is beneficial to mind or body|Vegetables are salubrious foods which provide essential nutrients.|
Salutary|producing good benefits|The board hopes the merger of the two companies will have salutary effects that will leave all the shareholders happy.|
Salutation|a demonstration of a greeting|It is customary to begin your letter with some type of salutation.|
Salutatorian|someone who graduates with the second best GPA in their class|Isabel knew she had big shoes to fill at Leonard High School since her father was valedictorian and her mother was salutatorian of this school twenty years ago.|
Salute|to show distinction to someone by raising the right hand using a certain gesture|During the military funeral, everyone notices the officer’s salute to the coffin as it passed by.|
Salvage|something pulled out or saved because of its value|The metal salvage we got from the old car is worth a tidy sum.|
Salvation|a thing that rescues a person or object from a dangerous situation|When the shipwreck survivor located a box of food, he knew he'd found his salvation.|
Salve|a cream or liniment that is used to moisturize and soothe the skin|Models for the cosmetic company were required to use a salve in order to have flawless skin for the commercials.|
Salvo|an act of firing two or more guns or other weapons at the same time|The soldier loaded his gun in order to complete the salvo.|
Samurai|Warriors of pre-modern Japan|Japanese Samurai warriors of the Edo period were the highest ranking class from the 1600-1800s.|
Sanctify|to make something holy|The priests have to sanctify the holy water.|
Sanctimonious|pretending to be better than others on a moral level|Even though the minister had been arrested for shoplifting, he still had the nerve to act sanctimonious in front of the congregation.|
Sanction|give official permission or approval|Because of the school’s behavioral problems, the principal is unlikely to sanction a school dance this year.|
Sanctity|the condition of being holy or having great value|According to many religions, it is a sin to terminate the sanctity of the marriage vows.|
Sanctuary|a place where one goes to be safe or to escape from life|My family knows not to bother me when I am relaxing in my sanctuary.|
Sanctum|a private place where no interruptions occur|Deep inside the sanctum, the lovers were able to enjoy each other’s company with no chance of being discovered.|
Sane|of sound mind and sensible|Wearing earplugs was the only way for the worker to stay sane in the noisy boiler room.|
Sangfroid|composure that is maintained even under great stress|Even as the building fell around him, the fireman maintained his sangfroid and rescued the little girl.|
Sanguinary|associated with events that produce bloodshed|The sanguinary fight left one of the students covered in blood.|
Sanguine|optimistic, hopeful, or confident about the future|Although the economy is looking better, we should still not be too sanguine about the future.|
Sanitarium|a hospital where people are treated for mental illnesses or chronic diseases|When he couldn’t handle the pressure anymore, the man’s depression got the best of him and he retreated to a sanitarium.|
Sanitary|to be clean and hygienic|After wiping the counter using a disinfectant spray, I knew the counter was sanitary for cutting vegetables.|
Sanitation|the process of maintaining cleanliness|Unfortunately, the sanitation crew wakes me up every Saturday from a sound sleep to take our trash from the driveway.|
Sanity|the condition of being mentally sound|Because the children were eager to get their inheritance, they challenged their elderly mother’s sanity in court.|
Sans|without|My plate was filled with steak and potatoes but sans shrimp since I am allergic to seafood.|
Sapid|having a strong and savory taste|The sapid steak was more appetizing than any other meat in the café.|
Sapience|wisdom combined with discernment|The difficult exam required both sapience and logical reasoning skills.|
Sapient|displaying great knowledge or insight|My sapient mother has helped me deal with a lot of relationship issues.|
Sapling|a young, skinny tree|A birch sapling grew in the middle of the forest as all the other trees had been chopped down.|
Saponaceous|pertaining to bubbly and soapy|After I drove into the school’s fundraiser car wash, two students poured a saponaceous substance covering my vehicle with white foam.|
Saporous|full of flavor; good-tasting|Stirring the saporous stew, the chef couldn’t wait to serve his flavor-packed simmer to his guests.|
Sappy|Overly sentimental or sweet|Viewers reviewed the overrated television drama as sappy and overly romantic.|
Sarcasm|a biting remark spoken to convey the opposite meaning|While Jason is amused by his sarcasm, no one else likes his smart remarks.|
Sarcastically|saying the opposite of what one means in a mocking or joking way|Joking sarcastically, the woman said, “Not all men are annoying, some are dead.”|
Sarcophagus|a stone coffin from ancient time|Peering into the sarcophagus, the archeologist’s eyes lit up when he saw the intact remains.|
Sardonic|displaying disrespect in a scornful way|Jim’s sardonic laugh made his parents angry enough to stop paying his cellphone bill.|
Sartorial|relating to clothing, fashion or dressing|Those with a developed sartorial sense can tell a cheap suit from an expensive one.|
Sashay|to walk in a way that attracts attention|Several high fashion models sashay down the runway by swinging their arms and their hips to the rhythm of the music.|
Sassy|feisty and vivacious|With a strong personality, the sassy girl would always answer the teacher’s questions in a funny and upbeat way.|
Satchel|a bag, often with a strap|Tossing his satchel over his shoulder, the mailman continued down his route.|
Sate|to satisfy; fill up|My family’s huge get-togethers are filled with so much food, they can sate the hungriest person.|
Sated|satisfied to the fullest; had more than one could enjoy at one time|Sated from the huge family feast, the stuffed couple retired to their bedroom for a midday nap.|
Satellite|a man made device used to collect information while orbiting around the Earth, moon, or another planet|A satellite recorded images of the house from way up in the sky and displayed them on the website.|
Satiate|to satisfy fully|Hopefully this feast I am preparing will satiate your hunger.|
Satiety|the state of being satisfied or full after consuming food|Sarah reached satiety and felt content after tasting every item on the buffet.|
Satire|a literary work or device that makes fun of its subject|The latest biography of the president is a satire designed to mock the leader.|
Satirical|having the qualities of mockery, sarcasm and ridicule|After reading the satirical piece of literature, I didn’t know whether to laugh at the sarcastic remarks or feel angry at it.|
Satirize|cleverly make fun of something|The poet looked for a way to satirize the boring poem and give it a more humorous appeal.|
Satisfaction|gaining joy or happiness from an achievement|Nothing brought her more satisfaction that pulling perfectly baked cupcakes from the oven.|
Satisfactorily|in a way that is adequate and meets expectations|Both students completed their tests satisfactorily and used their high scores to apply for top colleges.|
Satisfactory|adequate; satisfactorily acceptable|A satisfactory number of contestants must register for the contest in order for it to take place.|
Satisfactory|acceptable or good enough; meeting all requirements|Though her test scores were satisfactory, the test taker was sad she didn’t make a 100.|
Satisfied|content and okay with the way things are|The teacher was not satisfied with her student’s work, so she asked him to redo the inferior essay.|
Satisfy|to be of acceptable standards|In order to graduate from her high school, Lily had to take one more math class to satisfy the graduation requirements.|
Satrap|a local governor in the ancient Persian Empire|A satrap that served under King Darius were responsible for governing a Persian province.|
Saturate|to fill something to the utmost capacity|The company hopes to saturate the market with their products so consumers will think of its brand first.|
Saturation|to fill something or a place so completely that no more can be added|Because of market saturation, it would be silly to build another coffee shop in the area that has ten already.|
Saturnine|sad and solemn|The dog’s eyes became saturnine whenever he was left at home alone.|
Satyr|a creature of Greek mythology composed of a man and a goat that inhabits the wilderness and is known for its fondness of wine and women|Taking the form of a satyr, the mighty Zeus took the woman to be his own and retreated into the woods.|
Sauciness|something said rudely or in an ill-mannered way|As a result of the sauciness in his voice, the teacher sent the teenager to the principal’s office.|
Saucy|rude and cocky, usually in a lively way|With a saucy attitude, the waitress was able to engage and irritate customers at the same time.|
Saunter|to walk at a relaxed speed|Once it started to rain, we decided to saunter through the park another day.|
Sauntered|strolled at a unhurried pace|The teenage boy sauntered through the school as though he did not have a care in the world.|
Saute|to fry food quickly in hot oil|In order to saute the vegetables, the chef quickly increased the temperature on the stove and dropped in a pat of butter.|
Savage|out of control; untamed|The savage attack left the woman fighting for her life.|
Savagely|to do something brutally and viciously|When the dog incessantly barked, the hot-tempered man savagely beat the dog resulting in a bloody mess.|
Savagery|an exploit involving brutality and viciousness|Judge Watson handed the defendants the maximum sentence under Virginia law due to the savagery of the crimes.|
Savanna|a big area of grassy land that has few trees and is generally found in South America and Africa|With few trees on the savanna, the tourists had little escape from the heat.|
Savannah|an area covered with fields of grass and a few trees|While traveling across the savannah, the tribe realized this would be a perfect place to shoot the roaming game for its meat.|
Savant|one who knows a great deal about a specific topic|Although Jason is mildly retarded, he is also a chess savant who is considered to be one of the best players in the world.|
Save|keep and store up (something, especially money for future use|In order to save money, the family decided to stop going out for coffee and make it at home.|
Savor|to take delight in something for a long period of time|The team will savor the championship victory for years to come.|
Savory|having an appealing smell or taste|I could not stop eating the savory soup.|
Savvy|sharp; perceptive|Your help desk agent should be savvy about all the features of your company’s software.|
Saxicolous|growing or living among rocks|Lichen is a saxicolous organism that arises from algae and thrives on fresh rock.|
Saying|a simple statement that expresses some kind of truth or wisdom|The saying ‘love is blind’ means that people who are in love often ignore things that are very obvious to everyone else.|
Scabbard|a case that shields a dagger or sword|The pirate pulled his sword out of the scabbard attached to his belt.|
Scabrous|lewd and obscene|The scabrous magazine was regarded as a lecherous and vulgar publication.|
Scaffold|a temporary structure that holds laborers while they work on a building|The painting crew will earn over fifty thousand dollars for the job, but must pay three thousand for the new scaffold to hold the laborers.|
Scaffolding|a system of temporary structures that hold laborers while they work on a building|Three stories of scaffolding towered over the side of the building while the final coat of paint was being spread.|
Scalawag|an individual who causes trouble|Late last night, the neighborhood scalawag decorated the school with toilet paper.|
Scald|to be hurt by a scorching fluid|Even the smallest splash of hot oil on my skin would scald it causing severe burns.|
Scale|an instrument used to measure the weight of something|A scale was used to measure how many pounds each wooden block is.|
Scam|an immoral way of cheating someone out of their money or causing unsafe situations|After asking for a large sum of money, I knew the job was a scam because the people did not represent the company.|
Scamp|A playfully mischievous child|While his parents were sleeping, the little scamp snuck into the cabinet and ate all of the cookies.|
Scamper|to move quickly with light steps|Watching the squirrel scamper up the sidewalk was the highlight of the toddler’s day.|
Scan|to look at something carefully in order to find something|As he continued to scan the horizon, the hunter was able to spot a flock of geese in the distance.|
Scandal|an event that causes public outrage|The tax credit scandal led to the arrest of a high profile CEO and his shady accountant.|
Scandalize|to shock someone by doing something horrifying or immoral|The nun’s marriage to the priest was enough news to scandalize the entire town.|
Scandalous|an action or event that is considered outrageous or indecent|Senator Sill refused to answer the reporter’s question about his scandalous behavior last month.|
Scant|a tiny amount|We have to ration the water because we only have a scant amount.|
Scantling|a small portion of something|Because it is strong and very expensive, a scantling of saffron goes a long way in the couscous.|
Scanty|less than what is needed|Since the airline lost two of my bags, I have scanty clothing for my vacation.|
Scapegoat|a person or group made to bear the blame for others or to suffer in their place|Because the detectives could not catch the real killer, they arrested a vagrant as a scapegoat to calm the worried public.|
Scar|to permanently wound something or leave a permanent mark on it|The gash I received on my leg during the war will scar me for life, healing but always leaving a mark on my skin.|
Scarce|limited or sparse in number|Food was scarce during the Holocaust because many people were not allowed to grow their own food and had to ration what they had.|
Scarcity|a lack of something needed|The scarcity of water in the small town is destroying the livelihoods of most of the farmers.|
Scare|to frighten or make someone afraid|On Halloween, the teens dressed like spooky ghost and goblins to scare the younger children in the neighborhood.|
Scarify|to make scratches or small cuts into something|If you scarify a seed by cutting it before planting, it will grow better in the ground.|
Scarlet|a bright red color|Because she loves the color red, Tammy wears a scarlet dress to every event she attends.|
Scathe|to harm or injure|The would-be killer attempted to stab his ex-wife but got away before he could scathe her.|
Scathing|extremely severe or harsh|The scathing remarks brought tears to my eyes.|
Scatter|to throw in various and often random directions|The old woman sitting in the park would occasionally scatter birdseed around her to attract the fowl in the area.|
Scavenger|someone who scavenges, especially one who searches through rubbish for food or useful things|The vulture is considered a scavenger because it searches for dead prey.|
Scenario|a situation that could possibly happen|Before we launch our product, we need to have a solution for every scenario that could arise.|
Scene|the location or site where something occurs|Right after the accident, police arrived on the scene to help the crash victims.|
Scenery|the natural features of the land|They newly engaged couple stood at the top of the Grand Canyon and took in the dazzling orange scenery.|
Scenic|describing a view of nature that is beautiful or impressive|The White Cliffs of Dover are widely regarded as one of England’s most scenic locations, with a unique view that you won’t find almost anywhere else.|
Scent|a distinctive, often pleasant smell|I could not identify the sweet scent that lead me into my Grandma’s kitchen until I walked in to discover her baking bread.|
Schadenfreude|the sense of enjoyment that comes upon hearing about the problems of others|Summer was a strange woman who took joy in the suffering of others and always experienced schadenfreude when her friends were miserable.|
Schematic|a drawing or sketch using abstract, graphic symbols that shows how a system works in a simple way|While producing the schematic drawing of the Graystone Building, the architect began to assign tasks to start the project.|
Scheming|making underhanded or sneaky plans|Myra suspected that the whispering children where probably scheming and planning a weekend sleepover.|
Schism|a split or separation within a group or organization|The schism between my two best friends put me in the awkward position of having to choose one over the other.|
Schizophrenic|a person suffering from schizophrenia, a mental disorder characterized by abnormal social behavior and failure to understand what is real|The therapist specialized in creating behavior modification plans for people with schizophrenic disorders.|
Schlep|to haul or carry something heavy or awkward|The hikers had to schlep down the mountain carrying their heavy bags and other gear.|
Schlump|a lazy and sloppily dressed person who does everything in a slow or dull way|The lazy schlump sleeps in class when he does show up and rarely ever participates in discussions.|
Scholar|a highly educated person who attends school and studies|As a lifelong scholar, the specialist spent most of his years buried in academic studies.|
Scholarly|academic; intellectual|The scholarly student spent hours studying each day.|
Scholastic|related to academic studies or education|The teacher gave out scholastic awards to the students who worked the hardest during the school year.|
Scintilla|a small amount of something|Because it has strong flavor, the recipe called for a scintilla of sesame oil.|
Scintillating|remarkably witty|The host’s scintillating conversations with celebrities have earned her numerous awards.|
Scoff|to sneer or laugh with scorn|The rude little rich girl thought it was fun to scoff at the poor children at her school.|
Scoffed|laughed at with disdain or scorn|The billionaire heiress scoffed at the idea of eating a peanut butter sandwich.|
Scold|to strongly criticize|Female dogs sometimes scold their puppies by nipping on their ears.|
Scope|the extent or range of which something is deals with|The manager got off task and asked questions that were outside the scope of the current meeting.|
Scorch|to burn the surface something|Janine is a horrible cook and tends to scorch anything she puts in a frying pan.|
Scorching|extremely hot|On the scorching hot day, all the cowboy could think about was a drink of cool water.|
Scorn|to show disdain or contempt for something or someone|Even though Warren is a billionaire, he does not scorn anyone and treats all people equally.|
Scorn|disrespect or disapproval for someone or something|Though he did not mean to scorn the girl, his rejection came off as extremely offensive.|
Scorned|rejected or rebuffed|The snobby woman scorned the man’s offer to take her out on a date with a firm “no.”|
Scoundrel|a bad, dishonest person|The scoundrel stole my purse and ran off with it.|
Scour|to scrub hard|My mother made us scour the bathroom before our guests arrived.|
Scourge|a persistent pest, illness, or source of trouble|For several years, the drug violence in the border city was such a scourge on the population that it was named the murder capital of the world.|
Scowl|a frown of anger or displeasure|Whenever my husband looks at our noisy neighbors, he has a scowl on his face.|
Scrag|a bony or scrawny person or animal|Starving in the streets, the bony scrag begged for food from those passing by her famished body.|
Scraggly|used to describe a person who is very thin and bony looking|The prisoner of war’s scraggly body weighed less than a hundred pounds when he was released from captivity.|
Scramble|to move quickly or frantically to make something happen|The frantic team continued to scramble to make a goal but came up short at the end.|
Scrap|a left over piece of something that isn’t of any use|Every small scrap of paper found on the floor is put into a recycling bin on the 4th floor.|
Scrape|the abrasive action of rubbing against something (can be voluntary or involuntary) that results in the removal of dirt, skin, etc.|When the little girl feel off her tricycle, she fell on her face and got a long, jagged scrape on her chin.|
Screech|to give out a loud, piercing sound|Hearing the eagle’s loud screech from above, the rabbit hurried out of sight.|
Screenplay|the story script and shooting directions prepared for motion-picture production|The director followed the directions of the screenplay and instructed the actors on where to stand.|
Screw|to fasten or tighten something in place by turning it|The homeowner tried to screw in a lightbulb by turning it several times clockwise.|
Scribble|to write or draw something quickly or without much focus|I was bored in class, so I drew a little scribble on the back of my worksheet to pass the time, though I can’t remember what I drew.|
Scrimmage|a practice game which does not count on a team's record|Both football teams looked forward to their preseason scrimmage as they needed the practice badly.|
Scrooge|a gloomy grump|The young boy was being such a scrooge when he complained and made grouchy comments to his friends.|
Scrounge|to get things (usually of little value) by asking for them instead of buying them|At the garage sale, I had a customer who wanted to scrounge for free items.|
Scrub|to rub a service very hard, usually with a brush or some other object|The maid tried to scrub the dirt and grime off the floor, but couldn’t make it white again.|
Scrumptious|delicious; mouthwatering|Placing her nose up to the apple pie, the pastry chef got a whiff of the scrumptious smelling tart.|
Scruples|internal factors that prevent a person from behaving in a certain manner|Janet has no scruples about mistreating people who mistreat her.|
Scrupulous|very careful about doing something correctly|Will is a scrupulous employee who always checks his work for accuracy.|
Scrutinize|examine or inspect closely|Because of recent terror attacks, the airline screeners closely scrutinize all bags that are going on board airplanes.|
Scrutiny|careful examination of something or someone|If you want to fly on an airplane, you should be prepared to deal with scrutiny from the airline personnel.|
Scuffle|rough, disorderly fight or struggle at close quarters|In order to downplay the actual fight, the siblings told their parents the reasons for the bloody noses and torn clothing was due to a small scuffle they had a few minutes ago.|
Scullery|a small room, next to a kitchen, where washing up and other domestic chores are done|The scullery maid always washes dishes and preps for meals.|
Sculpture|a piece of art created by carving or chiseling away wood or stone|Taking great care while chiseling the block of ice, the artist believed that this would be his greatest sculpture yet.|
Scummy|dirty; nasty|Because the kitchen floor was so scummy, the maid had to scrub it with bleach for several hours.|
Scurrilous|something that is said or done to ruin a person’s reputation|Jeremy got me fired by telling my boss scurrilous lies about me.|
Scurry|to move rapidly using small steps|The mouse tried to scurry under the door.|
Scurry|to move hurriedly or quickly|The mice continued to scurry across the floor, moving quickly as not to be caught by the mouse.|
Scurvy|deficiency of vitamin C|Many sailors died of scurvy due to lack of access to nutritional food.|
Scuttle|to scamper or dash|Because I was running late, I had to scuttle through the airport parking lot.|
Scythe|a tool with a long curved blade at the end of a long pole, used for cutting grass or grain by hand|The farmer expertly guided the scythe through the wheat fields, collecting the harvest.|
Seafaring|sailing through waters on a regular basis|Seafaring merchants during the Renaissance would often travel throughout Europe and Asia to bring new inaccessible products to foreign customers.|
Seal|to fasten something shut|Once we seal the envelope closed, the letter is safe to put in the mailbox to be delivered to the recipient.|
Seam|the edge where two pieces of material are stitched together|A seam of the undershirt was quite noticeable through the thin flimsy silk blouse.|
Seamless|smooth and without interruption|His seamless execution of the challenging task surprised his coworkers and caught the attention of the higher-ups.|
Seamstress|a woman who’s profession is to sew and alter clothing|Leaving her job as a waitress, the young woman opened a tailoring shop and became a full-time seamstress.|
Sear|to char, scorch, or burn the surface of something with quick heat|The chef placed the steak in the hot pan to sear the outside.|
Search|to look for something that can’t be found at the moment|I continued to search for my lost keys, not realizing that they were in my hand the whole time.|
Season|to add flavor to something|Season the stone soup by adding herbs and other spices to the mixture.|
Seasonal|pertaining to a particular time of the year|Seasonal decorations adorned the restaurant tables at Christmas time with holly leaves and hanging greenery.|
Seasoned|to be skilled at something based on experience|Only a seasoned teacher could create an environment for learning with the wild and defiant students.|
Seat|something that one sits on|Pulling out a seat for his wife, Ben fixed the chair so that she would be comfortable.|
Secede|to withdraw from an organization, alliance, or association|Several members of the motorcycle club have made the decision to secede from the brotherhood and start a new organization.|
Seclude|to separate from people|The monks have made the decision to seclude themselves from society as a whole.|
Secondary|coming after something else that is usually more important|Instead of primary red, blue, and yellow, only secondary colors were used on the walls.|
Secondhand|describes goods that have been passed down after being owned by one other person|Tiff owns a secondhand store where people come to buy used items that are still in good condition.|
Secondment|a temporary period of time in which an employee is transferred to a new position or organization|The department head was required to find a couple of replacement workers since two permanent employees were on secondment in a different department.|
Secrecy|the act of keeping something secretly hidden|Judicial secrecy kept the final verdict under wraps until the official press conference.|
Secret|something that is not to be known or seen by others|Approaching the secret lair, the knight crept quietly as to not awaking the sleeping dragon.|
Secretary|an office assistant, usually in charge of records|Trying to impress the new secretary caused the office manager to spill coffee all over himself during the briefing.|
Secrete|to produce and give off|An octopus can secrete ink to ward off prey.|
Secretion|the process of releasing a substance (from an animal’s body)|When the woman reduced her sugar intake, her body’s insulin secretion lowered as well.|
Secretive|describes someone who hides their intentions, thoughts, and actions from other people|Secretive sorority sisters whispered in the hallway about new pledges and upcoming events.|
Sect|a small religious or political group that separates from a larger group. Sects have many of the same beliefs and practices as the original group, but often have some different doctrines|Our family are Mormons, which is a sect of Christianity.|
Sectarian|adhering strongly to a certain doctrine or sect|The sectarian preacher would not obey any laws that contrasted with his religious beliefs.|
Section|part or segment of something larger|Each section of the park has a map that shows you which segment of the square you are standing.|
Sectional|pertaining to a specific section or segment of a larger group|The U.S. Civil War was a sectional dispute, with the country being divided almost in half.|
Sectionalism|the condition of being focused on a specific section or sphere|It was Southern sectionalism that divided the nation and started the U.S. Civil War.|
Sector|a specific part of the country, economy, or a company|Our nonprofit sector is in need of a donation drive to boost funds.|
Secure|to attach something soundly|Forgetting to secure his bike with the chain, the boy was extremely disappointed to find that it was stolen overnight.|
Security|a private police force that is put in charge of guarding a person or a place|Armed security was hired to stop robbers from holding up the bank.|
Sedan|a two or four door vehicle that is made to hold at least four people|Purchasing a used four-door sedan was more reasonable than a buying a jeep since we live in a Seattle.|
Sedate|to soothe or calm|The shot should sedate the patient and allow him to sleep peacefully.|
Sedately|calmly, without excessive emotion|Because he was tired, everything he did was done sedately.|
Sedative|an agent or drug that sedates, having a calming or soothing effect, or inducing sleep|She was so upset at the loss of her husband, that the doctor gave her a sedative to calm her.|
Sedentary|staying or living in one place|Since the birth of my daughter, I have been enjoying a sedentary existence at home.|
Seder|a Jewish ritual dinner that marks the beginning of the Jewish holiday of Passover|A rabbi presided over the Seder, beginning with sanctification and a blessing being recited over wine.|
Sediment|collection of small particles|The apple cider had sediment in the bottom as part of the natural settling process.|
Sedition|the act of encouraging opposition to authority|The rebels were arrested for sedition when they protested outside of the dictator’s palace.|
Seduction|the act of enticing or attracting someone|The seduction of the now entranced audience was complete when the lead singer began her soulful crooning.|
Seductive|tempting; alluring|Seductive plates full of scrumptious shrimp and mouthwatering steak made the guests mouth water.|
Sedulous|diligent, hard working and persistent|Even though you completely destroy the ant bed time after time, those sedulous ants will continue to go right back to work rebuilding it.|
Seed|reproductive grains of a plant that are used to grow another plant|Covering the field with netting stopped the birds from eating the seed from the rows.|
Seek|to look for something|The police continue to seek the murder suspect and are setting up road blocks all over the city.|
Seemingly|apparently; appearing to be|The seemingly normal couple actually had many hidden secrets.|
Seemly|appropriate or suitable|The teacher quietly explained that throwing a temper tantrum is not seemly behavior for a fourth grade student.|
Seep|to slowly flow through a small opening|After hitting the bump in the road, oil began to seep out of my car’s radiator.|
Seer|a person who claims to be able to see the future|Being a seer, the man’s wife knew that destruction would befall their family the following week.|
Seething|intensely hot; boiling with anger.|The cook dashed some salt into the kettle of seething water.|
Segment|one part of something that is divided into sections|Smokers were the only segment of the society that were targeted by the tax increase.|
Segregation|setting apart or separation|Feminists complain about segregation between men and women in the workplace.|
Segue|to fluidly change from one form or situation to another|As the song was coming to an end, it would segue into the next tune without hesitating with silence.|
Seismic|Caused by or related to an earthquake|Seismic tests were conducted to determine the force of the earthquake.|
Seize|to gain through forcible means|If you do not watch the dog, he will try and seize the toddler’s lollipop.|
Seizure|The capturing of something by force|All of the stolen goods taken in the seizure are being stored in the police lock-up.|
Selcouth|interestingly strange or uncommon|The selcouth documentary was so unique that we couldn’t stop watching it.|
Seldom|hardly ever|Taking cocaine is seldom credited with improving a person’s intelligence.|
Select|to choose something|Taylor gets to select tonight’s movie since I chose the last one.|
Selection|a choice or range of different options|My sister and I had a hard time agreeing on a movie selection, so we ended up renting two different ones.|
Selective|intentionally choosing some things and not others|Being overly selective in love caused the prudish woman to end up an old maid.|
Self-assured|showing confidence in one’s self and your own abilities/skills|Confident and self-assured, there is nothing the man thought he couldn’t accomplish.|
Self-Concept|the image one has of him or herself|Many people have an inaccurate self-concept of themselves, thinking they are not worth as much as they really are.|
Self-conscious|uncomfortably over-conscious of oneself; worried or nervous by what other people think of you|During her speech, her body language portrayed her as self-conscious.|
Self-control|the ability to manage one’s own desires and behavior|Sheryl wanted to eat another donut but used self-control instead.|
Self-discipline|the ability to control one’s emotions and overcome one’s weaknesses|Lacking self-discipline, Kellyanne continued to overeat even though she knew she should stop.|
Self-evident|obvious and clear; not needing any explanation|The teacher’s instructions were self-evident, so no students asked any questions about the assignment.|
Self-explanatory|completely understandable; plain and clear|Once the science teacher distributed the worksheet with explicit steps and diagrams on it, the students felt comfortable with the self-explanatory lab.|
Self-preservation|a natural instinct to protect oneself from harm or death|The hero forgot about self-preservation and jumped into the fire to save the children.|
Self-righteous|believing that you are better, superior, and more moral than other people|With a self-righteous outlook, the snobby lady looked down on others from her moral high ground.|
Selfish|to think of oneself|Since he was known to be a selfish man, Darren never paid his child support even though he had plenty of money.|
Selfless|thinking only of others and not of oneself|A selfless individual often donates a fair sum of their money to charity even though they could use that money for themselves.|
Selflessness|the act of thinking of others instead of yourself|Her selflessness was displayed when Marta ran onto the tracks of an oncoming train to rescue the helpless toddler.|
Selves|essential beings or personalities of people|The two children seem to always to find their selves in trouble when they spend too much time together.|
Semantics|the message or meaning behind a term, phrase, or sentence|When you made a profanity-filled rant about me, the semantics were pretty clear.|
Semaphore|a mechanical gadget with arm, lights, or flags that is used as a signal|The railroad’s semaphore was broken, causing the car to miss the warning and come over the tracks.|
Semblance|an outward appearance of something; an assumed appearance|Once my divorce has been finalized, my life can return to a semblance of normality.|
Semi-final|a game or round just before the final match|The top two teams in each division will play off in a semi-final followed by a final to decide the winners.|
Semiannual|Happening twice a year|Semiannual fishing tournaments are held in both March and July.|
Semicircle|a half circle shape|Sitting in a semicircle of mismatched chairs, the arc of kindergarteners waited for their teacher to start the lesson.|
Semiconductor|a substance that is in between a conductor and an insulator, making it a good medium for controlling electrical current|Silicon is the best known semi-conductor and forms the basis for most integrated circuits.|
Seminal|important and highly influential on later developments|His award-winning performance was a seminal event for the college.|
Seminar|a training session usually lasting a few hours|Debbie and Lila only have enough time to attend the seminar on flipping houses instead of the detailed two-day workshop on the same topic.|
Seminary|a theological school that prepares students to become priests and pastors|The seminary’s academic courses range between traditional theology classes and practical internships.|
Semiotics|the study of signs and symbols, especially as means of language or communication|The semiotics of his body language revealed he was lying.|
Sempiternal|everlasting; having no start or no end|The girl’s parents tried to explain that images you put online are sempiternal and can last forever.|
Senate|a body of government that represents a specific area and reports to the national governing body; usually the group that writes and passes laws|The senate met to discuss implementing new laws against vandalism in the community.|
Senectitude|old age; the last stage of life|Although she is well into her senectitude, the eighty-year-old woman tries to combat her age with exercise.|
Senescence|old age|My grandfather said the best part of senescence is watching his grandchildren play.|
Senescent|growing old, aging|Our senescent dog is almost fifteen years old and is starting to suffer in his old age.|
Senile|confused or memory loss as a result of old age|I think my Grandma is going senile because she keeps forgetting her daughter's name.|
Senility|the physical and mental decline connected to old age|Dementia, also known as senility, is seen in elderly individuals whose mental states have started to decline.|
Seniority|refers to having a high ranking in an organization due to having been there for a longer period of time than others|Employees with seniority were given project preference over those who were new to the company.|
Sensation|a feeling picked up by one of the five senses|The burning sensation in the man’s eye only seemed to intensify as he flushed it with water.|
Sensational|astonishing and unbelievable|After working on the woman’s hair for over eight hours, her sensational hairstyle was admired and jealous by many women who saw it.|
Sensationalism|the presentation of stories by a journalist in a way that excites people emotionally, often at the expense of the truth or honesty|Feeding off the celebrity’s latest scandal, the article was full of sensationalism and exaggerations.|
Sense|the bodies ability to experience sight, sound, touch, taste, or smell|When Beethoven started composing music his sense of hearing was poor and got worse until he was completely deaf.|
Sense|to feel or know something|Although she couldn’t see the man hiding in the shadows, June could sense that someone was there.|
Sense|to detect or recognize|After entering the spooky house, the medium could sense several spirits moving about the room.|
Senseless|pointless; done for no clear reason|The family is devastated by the senseless murder of their young son who was at the wrong place at the wrong time.|
Sensibility|one’s ability to feel or be aware of something|President Lincoln’s sensibility about the situation helped him make right decisions regarding the abolition of slavery.|
Sensitive|highly responsive or reactive|The sensitive child demanded much attention from her parents as she was always getting upset over small and trivial things.|
Sensitivity|the tendency to be easily upset, influenced, changed, or damaged by outside factors|Because of her sensitivity to sunlight, the woman has to protect her fragile skin.|
Sensory|associated with the senses|The music at the concert was so loud it felt like a sensory attack.|
Sensual|inducing pleasurable or erotic sensations|The sensual couple’s massage was part of the honeymoon plans.|
Sensuous|associated with the senses|The hypnotist’s sensuous voice was very relaxing.|
Sententious|using few words, often in a preachy manner|Because the minister was in a hurry to get home to watch the football game, he gave a sententious sermon about the importance of valuing time.|
Sentience|awareness and the capacity to sense and feel, particularly pleasure and pain|His sentience failing him in the dark, the man was no longer able to see the corridor or decide which way to turn.|
Sentient|being able to feel or sense things|Humans are not the only sentient beings, elephants are very emotional and perceptive mammals as well.|
Sentiment|a thought, view, or attitude; an opinion|The sentiment in his love poem was so touching that it brought tears to her eyes.|
Sentry|a solider whose job is to stand watch and guard against intruders|Standing at the gate, the Iraqi sentry guarded the entrance to the embassy.|
Separate|to break something up or divide it into parts|The teacher tried to separate the fighting students but couldn’t get the two boys apart.|
Separately|occurring on an individual basis|The manager interviewed each candidate separately in an effort to determine who would be the best fit for the position.|
Separation|disconnection or detachment|Separation of Church and State allows the government to run without a connection to a particular religion.|
Separatist|of the belief in full separation of a group from a larger whole (usually based on race, religion, culture, or ethnicity.)|Separatist forces in the state worked to keep Muslims and Christians in different areas.|
Sepsis|a dangerous medical condition in which bacteria is present in the blood system|Bacteria in wounds can move into the bloodstream and lead to sepsis if not treated quickly.|
Septic|infected or contaminated with disease-causing organisms|After the wound became septic, it started oozing pus and turned green.|
Septuagenarian|a person who is in the seventy to seventy-nine age range|As she approached eighty, the septuagenarian wished that she could stay 79 forever.|
Sepulcher|a place where one is buried|When my mother dies, she will be placed in the family sepulcher alongside my father.|
Sepulchral|extremely gloomy|The siren would use her voice to lure sailors to their sepulchral deaths.|
Sequacious|tending to follow; missing original thoughts or independence|Because the girl was sequacious, she usually went along with the other students and never voiced a conflicting opinion.|
Sequel|a movie or book that continues a tale|The movie’s sequel picks up where its predecessor ended.|
Sequelae|aftereffects of a disease or injury|Fully recovered, the man had no aftereffects or sequelae six months after his surgery.|
Sequence|arrangement of events in a specific order|Switching up the sequence of the recipe steps caused the usually delicious brownies to turn out inedible.|
Sequent|consecutive or something that is next|When the old woman finished her transaction with the bank teller, the sequent person in line was waved up to the next teller.|
Sequential|going in order from first to last|Factoring in algebra is sequential and must be completed in order to get the correct answer.|
Sequester|to be put away for a specific reason|The people with the virus were told to sequester themselves at home to avoid spreading the illness.|
Seraph|the highest ranking angel in the Bible|Crying “holy, holy, holy”, the angelic seraph flew around the throne of God.|
Seraphic|angelic and stunning|When the children put on their angel costumes, they looked seraphic.|
Sere|dry and withered|The sere leaves that covered the ground were once healthy, but are now dry and brittle.|
Serendipity| the fact of finding pleasant or useful things by chance|The lottery is something one wins by serendipity not by design.|
Serene|calm; peaceful|The quiet beach made a serene setting for the midnight wedding.|
Serenity|untroubled, calm, and peaceful|For the outdoorsman, there is no way to experience serenity better than enjoying nature.|
Serf|a medieval peasant who was forced to work on a manor|The main duty of the serf was to work in the fields, but he was also required to serve at his lord’s house at least three days a week.|
Serfdom|the state of being a medieval peasant who was forced to work on a manor|Feudal serfdom was similar to later century slavery in that serfs were not allowed to leave the manor in which they lived and worked.|
Sergeant|a noncommissioned military officer ranking|Moving up in the Air Force, the sergeant was looked to for guidance and mentorship from lower ranking officers.|
Serial|describing a person who commits an act repetitively|Each of the serial killer’s latest victims were blondes who worked in the downtown district.|
Seriatim|relating to a series|A seriatim schedule is key to staying organized and completing tasks in an orderly manner.|
Series|a sequence or chain of people, things, or event|A series of tropical storms rose up in the ocean, causing destruction one after the other.|
Serious|requiring careful thought and deep consideration|I thought you were joking about how much weight you’ve lost, but now I can see that you were serious.|
Sermon|a speech or talk on a religious or moral subject|The sermon was about forgiveness.|
Serpent|a snake|The little girl screamed as the serpent slithered past her leg.|
Serpentine|marked by a twisting appearance, like the form of a serpent|The serpentine lake twists through the region providing the entire area with water.|
Serrated|having a row of sharp or tooth-like projections|A serrated knife allowed the chef to saw the bread into slices.|
Serried|rows of people or objects grouped together|Grandfather’s garden is serried in five rows, but it is too overgrown to notice.|
Servant|a person who performs working responsibilities for others|As a house servant, the slave was responsible for indoor chores rather than field duties.|
Serve|to work for or provide duties of service for someone else|At the dinner party, the maître D’ appeared to serve the guest their food.|
Service|work that is done for others as a business or an aid to others|A much-needed service in the area, the teacher decided to pet-sit during the summer.|
Serviceable|able to be serviced, examined, or repaired|Thankfully, the car’s engine is serviceable and can be repaired instead of being replaced.|
Servile|submissive; willing to serve others|Some individuals are so servile that other people take advantage of their submissiveness.|
Servility|eagerness to serve and please others|The janitor’s servility caused her to go above and beyond to make her employer happy.|
Sesquipedalian|a very long word|The word sesquipedalian defines itself by the amount of syllables it possesses.|
Sessile|an organism that is immobile and cannot move|The coma patient was sessile as she had not moved since she went into a coma a few years ago after the accident.|
Session|a period of time designated for a specific purpose|During the brief session, the committee members voted to increase funding for infrastructure.|
Setback|a reversal of progression|The principal lost his job, creating a financial setback for a few months until he found another one.|
Settee|a seat or bench with a back and armrests|You might not want to purchase a white fabric settee if you have children because the furniture would get dirty and difficult to maintain.|
Setting|the type of surroundings that something takes place in|The setting of this book is the Industrial era, as the entire story takes place in that time frame and around that area.|
Settle|to reach a decision or agreement|The sisters couldn’t settle their argument, so their mother took the bike from both of them.|
Settlement|a formal decision or agreement that settles a dispute|Unable to reach a settlement through the use of a mediator, the separated couple hired new attorneys and prepared for court.|
Settler|one who settles in a new location|The traveling gypsy decided to become a settler by purchasing a home in Colorado.|
Sever|to detach by cutting figuratively or literally|National leaders may sever ties with other countries who do not properly negotiate trade with them.|
Several|a number higher than two yet relatively low in number|During her walk, the girl was able to pick up several lemons to make a gallon of fresh lemonade.|
Severance|ending of employment|Offering of the displaced workers severance packages is the least the company could do before shutting down operations.|
Severe|very strong and intense|The severe thunderstorm caused so much damage that recovery would take years.|
Severest|the worst and harshest when compared to other severe events|Devastating hurricanes pop up all the time, but the last storm was the severest this coast has ever seen.|
Severity|the state of being strong and intense|The severity of the bomb threat resulted in two students being expelled from school and placed in a juvenile detention center.|
Sew|to create or repair by making stitches with a needle and thread|The cut on her cheek was so deep that the doctor had to sew a few stitches to mend it together.|
Sexism|gender discrimination and prejudice|Unfortunately, sexism and other forms of discrimination towards women are still very common in the twenty first century.|
Sextet|a musical piece written for six people to sing or six instruments to be played| With two altos, two sopranos and two bass, a sextet was written so everyone in the group could participate in the song.|
Sextuple|to be or have six portions or people|When the doctor scheduled the unhealthy man to a sextuple heart bypass surgery, the procedure would be dangerous since they would be fixing half a dozen arteries in the man’s chest.|
Shabbier|looking older and more worn out than something else|My dress was worn and tattered, but my sister’s gown was even shabbier than mine.|
Shabby|in poor condition because of age or wear|The college student’s apartment wasn’t what I would call chic, but it wasn’t shabby either.|
Shack|a small building that is not put together very well|The one room shack didn’t seem like much, but it was better than sleeping on the streets.|
Shackle|anything that hinders an individual from doing what he or she wants to do|The comedian referred to his wife as the shackle that prevented him from being with his dream girl.|
Shade|covering from the sun|Cala lilies love the shade and do not grow well in direct sunlight.|
Shadow|to follow someone|Since I want to become an attorney like my uncle, I sometimes shadow him at his firm.|
Shady|sly and suspicious|Every member of the secret round table meeting was either a shady mobster or a crooked politician.|
Shaft|the long handle of a weapon or tool|The shaft of the club was so rough that it rubbed a blister on the golfer’s hand.|
Shake|to tremble or quiver|The woman’s warm natured body would shake every time she felt the cool Chicago air nip and her nose.|
Shake|to tremble or vibrate|During the earthquake, the ground began to shake and gyrate violently.|
Shaken|upset and unable to remain calm|After the terrible car wreck, the shaken driver scrambled from the car trembling and in tears.|
Shakily|unsteadily; wobblingly|Taking the stage and slowly speaking into the mic, the nervous valedictorian shakily addressed his classmates.|
Shall|an alternative for the word ‘will’ that tells what someone will do|We shall go to breakfast at 8:00, if our cab arrives in time.|
Shall|will have to; must|The student shall overcome her fear of public speaking and give a speech at her graduation.|
Shallow|uninterested in things that are serious or deep; seeing only what is noticeable|A beauty pageant is a shallow contest in which people are judged mainly on their looks.|
Sham|a fake; an imitation that purports to be genuine|When we found out that the engagement was just a sham, we were very upset.|
Shaman|a tribal figure that serves as a go-between for the physical and spiritual worlds|The shaman of the tribe recommended that the girl not be buried immediately, as he wanted her spirit to have time to leave her body.|
Shambled|to move with a slow, shuffling, awkward gait|Moving at a slow and steady pace, the man shambled up the stairs to the guest bedroom.|
Shambles|a state of disorder or chaos|After the fraternity party, the house was in shambles.|
Shambolic|untidy or muddled|With so many lies and unbelievable stories during the election, many shambolic people couldn’t figure out who to vote for.|
Shame|the hot, nauseating feeling that comes with making a bad decision or of fool of yourself|The ballerina’s cheeks flushed with shame when she failed to land her jump during the dance recital.|
Shamefacedly|in a way that shows a person is awkwardly embarrassed|Once I had calmed down, I shamefacedly removed my ranting Facebook post from my timeline.|
Shameful|causing disgrace or embarrassment|Dumping 18 billion gallons of highly toxic chemicals into the Ecuadorean Amazon was one of the many shameful things that Chevron has done.|
Shameless|unacceptable; unabashed|I couldn’t stomach the author’s shameless self-promotion and quickly turned the channel.|
Shamrock|a three-leaved green plant (clover) that is used as a symbol for Ireland|If you are able to find a shamrock with four leaves instead of three, you will have the luck of the Irish.|
Shanghai|to abduct or kidnap someone|Pirates were able to shanghai several of our crewman by waiting for them just up shore from the dock.|
Shank|the leg of a person or animal|The dinner party was a success, with the biggest hit being the exotic bistro-style lamb shank that was served to the guests.|
Shanty|a shack or hut that is built shabbily|The river’s edge was covered with shanty after shanty, build by gypsies who decided to stick around for a while.|
Shard|a sharp piece of a broken material such as ceramic, glass, or metal|Grimacing as each shard of glass was pulled from his heel, the boy vowed never to walk barefooted again.|
Share|a portion or part of something larger that has been divided out amongst people|I became upset after finding out that my brother ate not only his piece of cake but also my share.|
Sharecropper|a farmer paying rent with crops to the landowner|The sharecropper was planting a field of soybeans.|
Shareholder|a person who owns a portion of a company|Each shareholder had an equal say in the company’s decision making process.|
Shark|a person who takes advantage of the misfortune of others for personal gain|The loan shark took advantage of the indebted couple and charged them an outrageous interest rate.|
Sharp-tongued|harsh or critical in speech|Curt and sharp-tongued, the director was vocally critical of all of the film’s performers.|
Sharp|having a pointed edge that cuts something easily|The sharp spindle pierced Aurora’s finger causing a drop of blood to seep out of the wound.|
Sharp|having an edge or point that can cut something|The doctor used the sharp blade of the scalpel to make a deep cut into the patient’s skin.|
Sharply|intensely; suddenly|Breathing in sharply, the man prepared to ask his girlfriend for her hand in marriage.|
Shatter|to break something into multiple pieces|The wayward baseball soared towards the window, serving to shatter it when it crashed into the glass.|
Shattered|broke into many pieces|Onlookers gasped as the urn dropped to the floor and shattered into dozens pieces.|
Shawl|a wool garment worn by women to cover their head or shoulders|Placing the shawl over her head, Little Red Riding Hood stepped out of the cottage and headed towards the woods.|
Sheaf|any collection of things bound together; a bundle|As he procrastinated, the accountant’s papers piled higher and higher in a sheaf that seemed to never end.|
Shear|to cut something, usually referring to the hair of a person or animal|One of the shepherd boy’s responsibilities was to shear the sheep when their wool was too long.|
