Amulet|a necklace with an ornament to ward off harm|Dressed in the traditional religious garb, the young woman threw the amulet around her neck in order to be cautious of the hexes.|
Amusement|fun or entertainment|Some cruel children hurt animals for amusement, but their actions rarely go unpunished, so they don’t enjoy it for long.|
Amusing|adding humor or fun to something|As Bobo the Clown entertained the group of three-year olds, it made for an amusing time for everyone.|
Anachronism|something that doesn't fit its time period, like if you say you'll "dial" your smartphone|Since there were not laptop computers during the Civil War, the presence of a portable computer in the history film is a definite anachronism.|
Anagram|a word formed from the rearranged letters of another word|I find it rather funny that the anagram ‘bad credit’ to ‘debit card’ exists, as a clear representation of how many people flounder with money.|
Analogous|similar|Because my teacher is analogous to my mother, I have accidentally called her, “mom.”|
Analogy|a comparison to show similarity between two things|In her analogy, the poet compared love to an endless well.|
Analysis|the breaking down of something complex into smaller elements so it can be evaluated|The sheriff was impatient as he waited for the analysis of the fingerprints.|
Analyst|a qualified person who can decipher data |The company called for a business analyst to help plan the budget for next year.|
Analytical|involving the approach of separating a larger item into smaller parts for ease of reviewing|The detective’s analytical mind allowed him to quickly process the crime scene.|
Analyze|to review thoroughly and in a logical manner|The psychiatrist will analyze the patient’s behaviors and thoughts in order to diagnose the condition.|
Anaphase|the stage in mitosis in which the cell starts to lengthen and the two members of each chromosome pair separate and move toward opposite poles|During anaphase, the cell’s homologous chromosomes are separated.|
Anaphora|repetition of a phrase used for emphasis|The poem was a great example of anaphora as it started each line with the same three words.|
Anarchist|a person who acts against the orders of a ruling body|As an anarchist, Jim is always pointing out the flaws of the government.|
Anarchy|chaos resulting from a lack of order or authority|As soon as the teacher stepped in the hall, the classroom descended into anarchy.|
Anathema|something or someone that one strongly dislikes; someone who is cursed or shunned|After the world learned of his heinous crimes, the dictator was considered an anathema.|
Anatomical|structural; bodily|The animal’s anatomical makeup includes several stomachs.|
Anatomy|the review of a plant or animal’s structure|In our anatomy class, we learned about the shapes and sizes of the organs in the human body.|
Ancestor|a member of your family who lived a long time ago|While researching my family tree, I noticed an ancestor of mine was born in Iceland at the turn of the century.|
Ancestor|family relative or thing that existed long ago|While researching my family tree, I noticed an ancestor of mine was born in Iceland at the turn of the century.|
Ancestral|referring to the family’s predecessors|Since my ancestral chart only showed my relatives who were blood related to me, I had to consult the family tree to determine the name of my great-aunt’s second husband.|
Anchor|a person or mainstay that can be relied on for support or security|Chicken is the chef’s anchor ingredient when he can’t come up with any creative dishes.|
Ancient|referring to something that is extremely old or something that happened long ago|To the boy, his grandfather was nearly ancient at eighty years of age.|
Ancillary|in addition to the main unit, worker, or task|If we start the ancillary generators, we should have enough power to keep the main generator online.|
Andragogy|the practice of teaching adult learners|Some teachers prefer andragogy because they would rather teach adults students than children, being less hassle.|
Androgynous|partly female and partly male in appearance|As an androgynous, Patrick’s gender will remain uncertain indefinitely.|
Anecdotal|not necessarily true or dependable, because based on someone's personal experience and not on facts or research|The anecdotal nature of the interview will never be considered proof enough in a court of law.|
Anecdote|a brief, often funny, telling of something that happened |Jillian’s anecdote about her crowded flight made us all laugh.|
Anecdote|an interesting or amusing short story|My favorite anecdote tells the story of an adventurous dog making his way through the city.|
Anemia|a medical condition in which your blood does not transport enough oxygen to the rest of your body, either because of too few red blood cells, or because of too little hemoglobin|When Frank was diagnosed with a red blood cell condition called anemia, we understood why he had been feeling so weary lately.|
Anemic|exhausted; weak|Although the woman was anemic, she made one final push in order to deliver her baby.|
Anesthetize|to give a person or animal medication that will put them in an unconscious or comatose state |The doctor will anesthetize the patient using Propofol so that he feels no pain during surgery.|
Aneurysm|an abnormal blood-filled bulge of a blood vessel and especially an artery resulting from weakening as from disease of the vessel wall |During a brain aneurysm, an artery fills with blood and blows up like a balloon before leaking blood into the brain.|
Anew|to take place once more|After divorcing her husband last year, she married anew to a man she only knew for about three months.|
Anfractuous|having many winding twists and turns|The couple struggled to get through the anfractuous maze, constantly getting lost in the twists and turns.|
Angelic|pure and innocent like an angel|The woman’s pure voice sounded both angelic and beautiful.|
Anger|a strong feeling of being annoyed, irritated, or hostile|Pounding his fists in anger, the upset toddler demanded that his mother feed him lunch.|
Angrily|with rage|The woman yelled angrily at her cheating spouse.|
Angry|having a strong feeling of being upset or annoyed|Even if I am angry at my husband, I try not to go to bed still upset.|
Angst|a mood associated with intense worry and unhappiness|A day before the fight, the inexperienced boxer was plagued with angst about losing his first match.|
Anguish|extreme suffering or grief|When my husband died, the anguish I felt was nearly unbearable.|
Angular|so thin or skinny that one’s bones can be seen |The angular boy was so thin you could see his rib cage.|
Anhedonia|the physical and mental inability to get feelings of pleasure from typically enjoyable activities|Depressed individuals suffer from anhedonia because what used to bring them joy only fills them with sadness.|
Anhydrous|describes a substance that has no water|The anhydrous mineral is unique because it lacks water in its makeup.|
Animadversion|a judgmental remark or criticism|The judge warned the hostile lawyer to not make another animadversion to the witness.|
Animal|a living, breathing organism|Amber’s favorite animal is a lion as she likes the way he roars when he’s mad.|
Animate|to become enlivened and stimulated|Once the upbeat music began, it seemed to animate the toddlers into jumping and dancing all around the room.|
Animated|active and energetic|In order to get the attention of her students, the animated teacher would throw her hands wildly around and move quickly around the room to explain a concept.|
Animation|the technique causing images to appear to move |Due to the computer animation, it is now possible to make cartoon films more quickly.|
Animism|a belief that natural objects have spirits|The philosopher argued that he does not support animism because of how rocks seem to clearly lack any kind of vitality.|
Animosity|a strong feeling of disliking someone or something|Why do you have such animosity towards me when I have done nothing to you?|
Animus|an intense feeling of loathing or disgust; hatred|My animus towards my roommate stems from the fact he is constantly stealing my food.|
Annals|a record of historical events (in chronological order)|The annals of the museum held many interesting artifacts.|
Anneal|to heat and slow cool metal or glass in order to toughen it|The welder was able to anneal the metal, heating it to make it stronger.|
Annexation|the official action of securing something by taking it over, often relating to land|To obtain lower property taxes, the citizens of the standalone area voted to approve their district’s annexation into a nearby town.|
Annihilate|to destroy, to eradicate|During the war, our soldiers will annihilate the enemy and secure our land.|
Anniversary|the date on which an even took place the year before|Celebrating their anniversary with a candlelit dinner, the couple was happy to be married for another year.|
Annotate|to add notes to a text or diagram in order to provide additional insight and understanding about something|The student is free to annotate the textbook with notes, as well as to highlight any text that they choose.|
Annotation|a note or comment added to a document or book|Surprisingly, my critical professor returned the rough draft of my essay without a single annotation.|
Announce|to give out news in a public way|The salon will announce the winner of the free hair cut on their Facebook page at noon.|
Announcement|a public statement or report that gives information to those listening or viewing|During the family get together, the happy couple made the announcement that they were having a baby.|
Annoy|to irritate or bother someone to the point of aggravation|The buzzy fly continued to annoy the house guests until someone finally stood up and swatted the pest.|
Annoyance|irritation; nuisance|Bernie’s state of annoyance was aggravated by the non-stop pestering of his crazy neighbor.|
Annual|happening once a year|We worried that our state would impose water rationing because of how little annual rainfall we had received this year.|
Annuity|an allotment of money paid from an insurance company either in a full payment or in installments usually for retirement purposes|Due to a small pension from her job, Matilda considered buying an annuity at the Lawton Insurance Company so she could live freely during her retirement.|
Annul|to officially make something invalid |After the actress tied the knot with a stranger in Mexico, she was persuaded by her manager to annul the marriage.|
Anomalous|unordinary, unusual, or distinctly different from the norm|The scientists at the weather station were extremely worried about the anomalous readings they were getting from their instruments, as they were far beyond the norm.|
Anomaly|something unusual or unexpected|In order to find the anomaly, scientists had to repeat the experiment over a hundred times.|
Anomie|social instability caused by erosion of standards and values |Carl claims that the children of gangsters are prone to anomie because they were never raised with a sense of right and wrong.|
Anon|in a short time; soon|The game will begin anon so hurry up and get here!|
Anonymity|the condition of having one’s identity unknown|For anonymity, the famous actress wore dark glasses and a baseball cap while walking in the park.|
Anonymous|not named|The donor requested to remain anonymous so that others wouldn’t bother him for money.|
Answer|to give a response|The student raised his hand to answer the question, but the teacher called on someone else.|
Antagonism|strong dislike|After deciding to become a cheerleader, the teenage boy had to deal with the antagonism of his peers.|
Antagonist|a challenger or foe|Do you think the antagonist is going to kill the hero at the end of the movie?|
Antagonistic|showing or feeling aggression or hostility towards something|My step-brother has always been very antagonistic towards me, never sharing his things or spending any time with me if he can help it.|
Antagonize|to trigger hostility or anger|If you antagonize the dog, he will bite you.|
Ante|to make an investment in money before knowing one’s chances |Every player is required to place an ante of the chosen amount into the center of table when playing poker.|
Antecedent|something that came before something else and may have influenced or caused it|Can you identify the antecedent that led to Jane’s emotional breakdown?|
Antedate|to occur before something else| In general, sex will normally antedate a pregnancy.|
Antediluvian|greatly out of date|My daughter often tells me I wear antediluvian clothes that are way out of style.|
Antemeridian|in the morning or before noon|The antemeridian brunch was held before noon so that more people could attend.|
Anterior|nearer the front|Marc’s anterior teeth are yellow, although his molars are pearly white.|
Anteroom|a small waiting area that leads into a bigger room|The principal makes the students wait in his anteroom before he calls them into his office.|
Anthem|a song that is said to represent the masses, whether it be cultural or social|Lady Gaga’s “Born This Way” became an anthem for the LGBT community.|
Anthology|a collection of writings|The band’s anthology was set to release in a few days.|
Anthropoid|having characteristics of a human being, usually in terms of shape or appearance|While visiting the zoo, we watched a monkey peal a banana in such an anthropoid way.|
Anthropologist|an individual who studies the development of human beings|As an anthropologist, Sara spends her days examining the evolution of human beings.|
Anthropology|the study of the origin of mankind|By examining past societies, those learned in anthropology believe they can solve world issues today.|
Anthropomorphic|having attributes of humans|The boy’s favorite cartoon stars an anthropomorphic cat who talks and walks like a person.|
Anthropomorphism|giving human traits to objects and living creatures that are not human|The author uses anthropomorphism to give human personalities to her animal characters.|
Anti|opposed to or against|The world is almost entirely anti-imperialism these days, condemning any country that would try to expand its own borders through conquest.|
Antibiotic|any substance that can destroy or inhibit the growth of bacteria and similar microorganisms|Her doctor said that she should take an antibiotic because it will help her fight the bacterial infection that is causing her strep throat.|
Antibody|a blood protein your body creates to fight disease|Finding the right antibody to fight the contagion is critical and can determine between life and death.|
Anticipation|the condition of being excited about something that is going to occur|In anticipation of the baby’s arrival, we have prepared the nursery.|
Anticipatory|happening or performed in anticipation of something|The soldiers took anticipatory defensive positions, preparing for the wave of attackers that would no doubt assault their position within the hour.|
Anticlimactic|lacking climax, disappointing or ironically insignificant following of impressive foreshadowing|Although the child anticipated that the gift would bring him endless enjoyment, it quickly turned into an anticlimactic experience.|
Anticlimax|a shift from an exciting event to a disappointing event|As the story wrapped up, it became apparent that Sonny’s break-up with his girlfriend would be the anticlimax.|
Antics|silly or outrageous conduct|The students’ disruptive antics caused the speaker to stop talking.|
Antidote|a substance to counteract a poison|Because he was bit by a snake, they had to give him the antidote so he would survive.|
Antigen|a toxin or foreign substance that causes the body to produce antibodies|After many tests were conducted, it was discovered that he carried the antigen for a genetic disorder.|
Antinomy|an apparent contradiction between valid conclusions|The Kansas born man spoke antinomy when he stated that all Americans are liars.|
Antipathy|a feeling of dislike|The source of my antipathy is my ex-husband’s new wife!|
Antipodes|a nickname for Australia and New Zealand|Far from the antipodes, the couple was homesick for both Australia and New Zealand.|
Antiquated|dated; from the past|Why would such a young woman wear antiquated dresses that make her look like an old lady?|
Antique|an old piece of furniture, household item, or other similar item|After researching the antique car, I became aware that it was over 100 years old and came directly off of Ford’s assembly line.|
Antiquity|an out of date period|While many females got married in their teens in antiquity, today women tend to marry in their later years.|
Antiseptic|very clean and free of disease-causing organisms|While cleaning with an antiseptic spray, I realized my friend would find it impossible to say anything negative at our playdate about any germs being in the house.|
Antisocial|unwilling or unable to associate normally with other people|People say that I am antisocial because I don’t talk that much.|
Antithesis|the total opposite of an object or person|In the movie, Robert’s character of an abusive husband is the antithesis of the caring spouse the actor really is.|
Antitrust|a law against trusts and monopolies, designed to promote competition in business|Antitrust laws are in place to prevent companies from having a monopoly on any good or service.|
Antonym|a word that means the opposite of another word in the same language|One antonym pair we are very used to in driving is ‘go’ and ‘stop,’ for obvious reasons.|
Anxiety|an uncomfortable feeling of worry or nervousness|Because she was suffering from anxiety, her therapist recommended taking some medication to help.|
Anxious|worried or concerned|Sylvia was anxious to finish her speech since getting in front of a large crowd of people made her tremble.|
Anyway|anyhow; nevertheless|I figured that he mall would be very busy on Saturday afternoon, but I decided to go anyway.|
Apart|to be separated by a typically considerable distance|The two lovers were struggling with the rules of their people that kept them apart, and they decided to flee the stratifications of their home.|
Apartheid|discriminatory policy of racial separation used by South Africa|Apartheid was discrimination against Africans based on skin color or ethnicity.|
Apathetic|having little or no interest or concern|The employee’s apathetic attitude was apparent in the rude way he greeted customers.|
Apathy|a feeling of having no interest in or enthusiasm|While some of the group’s members could not stop talking during the budget discussion, other members were frozen with apathy and did not engage in the conversation.|
Apathy|a feeling of having no interest in or enthusiasm about anything|The serial killer’s lack of apathy left even the judge speechless.|
Aperture|a gap such as a hole or cavity|The missile left a gigantic aperture in the wall of the terrorist’s hideout.|
Apex|the greatest or topmost position|At the apex of our country sits the president of our nation.|
Aphorism|a brief and witty saying|While Ted’s aphorism was short and funny, it was enough to make us briefly forget our father was having life-saving surgery.|
Aphotic|a region of water that is so deep that it does not receive sunlight|In the aphotic section of the ocean, many sea creatures have the ability to glow in the pitch black depths.|
Aphrodisiac|something that produces or enhances desire of a sexual nature|My husband hoped the aphrodisiac would stimulate his sexual desires.|
Apiary|a place where bees and hives are kept |Although he spent many hours daily in the apiary, he was seldom stung by a bee.|
Apical|top, important, best, highest|When he was elected president, it was an apical point in his life.|
Aplomb|confidence and skill shown, especially in a difficult situation; keeping your cool|Because the negotiator handled the hostage situation with aplomb, the kidnapper released everyone without harm.|
Apocalypse|a huge catastrophe that causes devastating destruction and loss|Many religious groups believe an apocalypse will one day terminate the lives of all sinners.|
Apocryphal|well-known but probably not true|Scientists claim the apocryphal story about creation is not true.|
Apodictic|unquestionably true or certain|After spending 16 years teaching English, I had an apodictic assurance that I could pass an adolescent literature class.|
Apogee|the highest point|The apogee of my happiness was when I married the love of my life.|
Apologetic|remorseful; sorry for committing a wrong|Though she pretended to be apologetic, Lesley wasn’t really sorry for the things she had done wrong.|
Apologize|to express regret for one’s actions; to say that you are sorry|The woman’s stubborn boyfriend never likes to apologize, even when he knows he was wrong.|
Apology|an expression of regret; remorse |The Congressman has made mistakes, as he himself acknowledged during a televised apology last weekend.|
Apoplectic|incredibly angry|The victim’s family was apoplectic when the case against their son’s killer was dismissed.|
Apoplexy|the inability to speak or perform as a result of an intense emotion or serious medical condition|During a bout of apoplexy caused by anger, Jim couldn’t respond to the accusations made against his wife.|
Apostasy|the act of renouncing one’s religious beliefs|After Sue underwent her apostasy, she declared herself an atheist and never returned to church.|
Apostate|an individual who has rejected his faith or religious convictions|When John challenged his church’s views, the leaders began to see him as an apostate.|
Apothecary|a person who makes and provides/sells drugs and/or medicines|When she realized that she was sick, the young woman sought the assistance of the local apothecary.|
Apothegm|a short, witty, instructive saying|"Don’t cry over spilled milk" is an apothegm which has become worn from overuse, but which will forever remain true and relevant.apothegm which has become worn from overuse, but which will forever remain true and relevant.',3,1,3);"> 🔊|
Apotheosis|perfect example of something or the best point in one's life or job|I consider the apotheosis of my career to be when I received CEO of the company.|
Appalled|struck with horror|When the stranger approached us and pulled down his pants, we were appalled.|
Appalling|very bad|The guru’s lie was appalling to those who followed his teachings.|
Apparatus|the tools, equipment, and machinery you use for particular purposes|The firefighter donned a breathing apparatus before entering the blaze, to search for people trapped in the inferno.|
Apparel|clothing|Shirley needs learn about different kinds of apparel that are fitting for various social settings, so that she does not stand out like a sore thumb.|
Apparent|clearly visible or understood; obvious|After the jury listened to the witness talk about the murder, it became apparent that he had never witnessed it.|
Apparition|a ghostly appearing figure|Casper the Friendly Ghost is a cartoon apparition that even little kids can be comfortable with.|
Appeal|to make a request for|I have made an appeal to my parents to reduce the length of time I am grounded, but so far I have had no success in convincing them of that.|
Appealing|tempting; alluring|After a week without food, even insects were appealing to the starving sailor.|
Appear|to become visible; to come into sight|The magician made the rabbit appear out of nowhere, surprising the audience who were shocked to see it hop out of the hat.|
Appearance|what something looks like|Having just drove through a bunch of mud on his ATV, Mark’s appearance was little more than wet brown dirt on every inch of his face.|
Appease|to make (someone) pleased or less angry by giving or saying something desired|When I reported the cashier’s poor customer service, the manager tried to appease me with the offer of a free pizza.|
Appeasement|to calm or persuade into an agreement usually in the angry party’s favor|The appeasement of the angry mob was only possible when the governor spoke to their leader and came to an agreement.|
Appellation|a term or title by which a person or thing is identified|Because there is no appellation on the product, consumers are confused about the brand's name.|
Append|attach; affix|The charm bracelet had acquired so many charms that Stacey had a hard time finding space to append her newest one.|
Appendage|a limb or other extremity that stick outs from the upper or lower portion of a body|Using a claw-like appendage, the videogame monster killed the soldiers.|
Appendix|the last part of a book or essay where extra information pertaining to the topic is included; sometimes with a graphic aid|“Your APA paper should contain an appendix located after the works cited page of your paper,” said the professor to his students.|
Appetence|the state or action of desiring or craving|Watching how donuts were made gave Greg an appetence for a soft, warm, glazed donut.|
Appetite|a strong desire for something|Because I’m so hungry, I have a real appetite for just about anything edible at this point.|
Appetizing|appealing or attractive, typically in reference to food|The melted cheese of a grilled cheese sandwich is extremely appetizing when I am hungry.|
Applaud|to congratulate by clapping|Following the wonderful performance of the local opera company on opening night, the audience did applaud by standing up at the end and cheering.|
Applause|the act of praise publicly expressed by the clapping of hands|During the Olympics the crowd was instructed to hold their applause until the end of the gymnast’s performance.|
Appliance|a piece of equipment designed to perform a domestic task|The dishwasher is a staple appliance in American kitchens, and has been for many decades, alongside the sink.|
Applicable|suitable for application, relevant|The judge said that New Jersey law was not applicable in this case because the crime took place in Delaware and that the criminal had not driven over state lines.|
Applicant|one who applies for something; one who makes a request|The company has promised to see all applicants who meet the specification for the vacant job.|
Application|an official permission to a higher figure for something|Since I needed to travel to another county, I was required to fill out an application for a new passport six weeks in advance by completing the required form.|
Apply|to smear or rub a substance on something else|I need to apply sunscreen all over my pale skin before I go out in the sun.|
Appoint|to assign a responsibility, job, or role to someone|After the scandal broke, the CIA was quick to appoint a new director with no ties to the former director who was now heading to jail.|
Appointed|to pick or choose for a task, duty, job or title position|After Scalia’s death, the president appointed the replacement for the Supreme Court of the United States.|
Appose|to place things next to or near another thing|The artist chose to appose the two students beside one another so he could paint them at the same time.|
Apposite|fitting for the situation or suited|My daughter and I usually disagree about which clothing items are apposite for school.|
Apposition|a grammatical relation between an adjective and the noun behind it|In the movie title, “My Fair Lady”, my fair is in apposition to the word lady.|
Appraisal|an opinion or estimated value|Though my car was in good condition, the appraisal of my vehicle came back with a below trade-in value.|
Appraised|to have had its worth evaluated|The insurance company appraised the famous painting at ten million dollars.|
Appreciable|adequately considered to be substantial or significant|After providing her medical records, the young student’s appreciable impairment was taken seriously now from her teachers.|
Appreciate|to understand the worth, value, or importance of something|As an art dealer, the man can appreciate fine pieces and see their worth in a way that others can’t.|
Appreciative|displaying or feeling gratitude|My appreciative daughter thanked everyone who gave her a birthday present.|
Apprehend|to catch a person for criminal reasons|Hopefully the law enforcement agents will apprehend the killer before he harms anyone else.|
Apprehension|capturing and arresting a lawless person|Both the army and the police were involved in the apprehension of the terrorists.|
Apprehensive|worried that something bad may happen; afraid|With recent job cuts, Kate is apprehensive about losing her job.|
Apprentice|trainee (beginner) especially in a skilled trade|Before he became a professional, he worked as an apprentice in the industry.|
Apprenticeship|job training that involves working for an expert to learn a particular trade|James took a culinary apprenticeship to learn the skills necessary to become a chef.|
Apprise|to report on the status of something|The scouts went back to apprise their commanding officer of the enemy’s location.|
Approach|so come near something|The hunter tried to approach the deer quietly so he would not scare it away.|
Approachable|easy to talk to|Due to my approachable teacher, I felt comfortable asking her any question about physics without feeling dumb.|
Approbation|to gain approval|I need to write a powerful resume to gain approbation from an employor.|
Appropriate|right or suited for a particular situation|Her speech on retirement was appropriate for her middle-aged audience.|
Appropriation|money set aside for a specific purpose|Joy works at city hall where she gets to oversee the appropriation of funds to both the public school and the public library systems.|
Approve|to officially accept something, considering it good or okay|Before the bank will approve your loan, you must sign a note promising to repay the money with interest.|
Approximate|close to the exact; estimated|Because Jack did not want to place an exact figure on how much he was willing to spend, I asked him for an approximate ball park figure.|
Approximately|close to, but not exactly|The newborn baby weighed approximately 8 pounds, but I would need to look at his birth certificate to be certain.|
Appurtenant|belonging|Appurtenant to the property, the single oak stump was an eyesore to both the owners and the neighbors.|
Apropos|fitting; at the right time|Justine’s apropos comment fit in perfectly with our discussion.|
Apt|likely to do something|The apt student was on his way to claiming honor roll status.|
Aptitude|the capability to do something well|The aptitude test will identify your strongest areas in math.|
Aptly|in a fitting way|When my aunt labels my moody uncle as grumpy, she aptly refers to him.|
Aptness|being suitable or right for something|Michael’s long legs given him an aptness for being a good track athlete.|
Aquatic|associated with water, often living in or taking place in water|All aquatic activities will take place in the indoor pool.|
Aqueduct|an artificial channel that is constructed to transport water from one location to another|Once completed, the aqueduct will carry fresh water into the mainland.|
Aqueous|associated with water|The punch is an aqueous solution composed of water and fruit juice.|
Aquifer|a rock deposit that bears water and is under the ground |Several people became ill after drinking water from the aquifer located under the chemical plant.|
Arabesque|a graceful, Arabian design usually seen in metal, ceramic, or stone that resembles vines and leaves|Arabesque gates with curving iron doors guarded the entrance into the garden.|
Arable|adequate for cultivating|The soil in the front yard is arable and perfect for planting a rose garden.|
Arbiter|one who can settle a disagreement between parties|An arbiter will help the divorcing couple come to terms on a settlement.|
Arbitrage|a method of buying something for one price and then immediately selling it for another price somewhere else|The broker decided to use arbitrage techniques to buy foreign stocks at a discount and quickly unload them in the US.|
Arbitrary|not done for any particular reason; chosen or done at random|In spite of the cold weather, we made an arbitrary trip to the beach.|
Arbitrate|to settle an argument between two people or groups after hearing the opinions and ideas of both|Often, I am called upon to arbitrate disagreements between my two best friends.|
Arcane|understood by only a few; obscure|Because it is no longer taught in schools, people are concerned that cursive writing will become arcane.|
Arch|a semi-circle shape, like an inverted "U"|Write the letter U upside down to best visualize an arch.|
Archaeology|the study of the past by excavation and analysis of its material remains|Thanks to the efforts of archaeology, excavators were able to discovered a new species of dinosaur.|
Archaic|old and no longer useful|Because my archaic computer is no longer useful to me, I am giving it away for free.|
Archenemy|a main enemy that is extremely opposed to someone or something|Glaring at this archenemy, the runner was determined to beat him in the race.|
Archetype|an ideal example that people often attempt to duplicate|The film that won the best picture award should be considered the archetype of all future movies.|
Archipelago|a group of islands|After island-hopping in the Aegean Sea, the tourists slept for a couple days due to previous excessive boating and walking to the different islands on the archipelago.|
Architecture|the science of designing and constructing|The architecture of the boat was supposed to make the vessel unsinkable.|
Archive|a collection of historical documents or records providing information about a place, institution, or group of people|The archive was full of photographs, letters, and historical documents from WWI.|
Archly|cunningly or slyly|The thief archly planned the robbery.|
Ardent|feeling great passion, or felt very passionately|When the rock star checks his mail, he almost always finds one or two bizarre gifts from some of his ardent fans.|
Ardor|great warmth of feeling; passion|While Jane enjoyed spending time with John, she did not return the ardor he felt for her.|
Arduous|demanding great effort or labor; difficult|Last semester was a piece of cake, but taking seven classes along with an internship this semester is going to be arduous!|
Area|a particular geographic region|The Everglades are an area of swamp in southern Florida.|
Argot|a unique language used by certain groups or people with a particular occupation|The old woman could not understand the argot her granddaughter used to communicate with her friends.|
Arguably|possibly or probably|Ms. Ray believed that her chocolate cake would arguably win the top prize at Florida’s Cake Contest.|
Argue|to give reasons for your support or condemnation of certain ideals, typically in an aggressive manner|If you wish to argue for an ideal that you believe in, you are better off relying on logic than emotion.|
Argument|a discussion where both sides explain their contrasting viewpoints usually with an angry tone|Everyone in the apartment complex could hear the argument between the couple due to their loud voices and the thin walls.|
Argumentative|predisposed to debating, disagreeing, or expressing controversial opinions or beliefs|An argumentative student will often disagree with the teacher just for the sake of doing so rather than having a good reason.|
Argyle|a pattern that features a series of diamonds and a solid colored background that was originally modeled from Scottish tartan|The doting grandfather made a habit of wearing argyle vests because his granddaughter loved to trace the diamond patterns and nuzzle into the wool.|
Arid|incredibly dry; lacking water |The crops will not grow in the arid ground because the soil is too dry.|
Aridity|long term lack of rainfall or moisture|The aridity of the soil was not ideal for planting.|
Arise|to get up from a seated or laying position|Once the small children saw the sun peak through their windows, they would arise and go downstairs on Christmas day.|
Aristocracy|a group of people who are viewed as being better than others, usually because of a title or status in society|The richest people in our town are considered to be the town aristocracy.|
Aristocratic|relating to nobility or upper class|The man’s aristocratic background caused him to crave fine dining and lavish parties.|
Armada|a fleet of warships|During the war a country’s navy sent its armada to attack its enemy.|
Armament|military weapons or equipment|The armament technician’s job is to make sure that all of the troop’s weapons are in working order.|
Armistice|a break from fighting which gives two warring factions time to negotiate peace|The accidental firing of the missile broke the armistice and destroyed the chance of peace between the two nations.|
Armor|metal coverings that are worn to protect one’s body, especially during battle|The soldiers dressed their bodies in armor and prepared to face their enemies on the battlefield.|
Aroma|a distinctive, typically pleasant smell|A pleasant aroma rose from Janet’s oven, as her apple pie neared completion.|
Aromatic|fragrant or strong-smelling|The aromatic scent of grandma’s spaghetti sauce wafted through the house.|
Arose|to start to exist or occur|A disagreement arose during the game, and the referee had to clear the field to end the fight.|
Around|nearby; In the area|There is supposed to be a park around the corner, but we haven’t been able to find it.|
Arouse|to stimulate or provoke a reaction or response|After Sandy began asking her friends to lie about her whereabouts on the night of the crime, she began to arouse suspicion from the detective.|
Arraign|to charge someone in a court of law|His lawyer was not present when the suspect was set to arraign.|
Arraignment|to take before a judge based on charges brought against the person|The community was relieved when the gang members were arrested and brought in for an arraignment.|
Arrange|to plan or set up|The musician tried to arrange a meeting at the record label, but no one would agree to meet with him.|
Arrangement|how something is positioned or displayed|Anna worked on the arrangement of the flowers, positioning each rose in a specific way.|
Arrant|complete, total, or utter (example: "arrant nonsense")|If you allow your son to participate in such arrant nonsense with his friends, he’s going to end up either hurt or in a juvenile detention center.|
Array|a large collection of things or people|The store offers an array of neckties for sale, of every color, stripe and texture.|
Arrest|to seize someone and take them into legal custody|The police officer decided not to arrest the woman even though he could have taken her to jail.|
Arresting|fascinating; striking in an eye-catching way|The eye-catching painting was visually arresting to all of the art gallery visitors.|
Arrhythmic|having an irregular beat or pace|After diagnosing the patient with an arrhythmic heartbeat, the doctor knew he needed to prescribe medication to get the beat back into a steady rhythm.|
Arrival|the act of reaching the place to which you were traveling|Because of the blizzard weather, my arrival to New York will be delayed.|
Arrogance|a rude and insulting way to act that comes from thinking you are better and more important than other people|The sheer arrogance of Hitler to think that he could dominate the world was shattered when he assassinated himself in his bunker.|
Arrogant|one who rudely acts as though he is better than other people|The arrogant young man quickly discounted his friends' suggestions.|
Arrogate|to seize without having the right to do so|The gang is trying to arrogate the public park and turn it into their private meeting space.|
Arsenal|a stock of weapons|When they arrested the suspect, he had an arsenal of firearms in his possession.|
Arsenic|a very harmful substance that kills people and animals that ingest it|The husband was accused of sprinkling arsenic on his wife’s food in an effort to kill her.|
Arson|illegally setting something on fire|Fire investigators suspected arson when they couldn’t find an electrical source for the fire.|
Artful|showing creativity or skill|The photographer’s artful shot showed a new side of the great wall.|
Arthritis|inflammation and stiffness in the joints|Timothy’s doctor explained that the sharp pains in his joints were caused by arthritis.|
Article|a story or report that you can read in a newspaper, journal, or online|I read an article in the newspaper about the effect of social networking sites on children.|
Articulate|expressing oneself clearly|A polished speaker, Jenna was able to articulate her points during any discussion.|
Artifact|a handmade object that is often found in some type of archaeological dig |The artifact was discovered near the site of the ancient burial ground.|
Artifice|a move made to obtain an advantage or trick someone|The company’s artifice centers on lowering their prices to the point that no other company can compete.|
Artificial|man made and/or unnatural|The health-conscious mother banned anything with artificial flavors from the house.|
Artillery|long range explosive bombardment weapons, such as cannons or mortars|During World War Two, battleships served as artillery for many of the island invasions the US underwent against Japan.|
Artisan|skilled craft worker who makes or creates things by hand|The artisan cheesemakers specialized in making cheeses on their small dairy farm.|
Artistic|having or revealing creative skill|Ways to be artistic include writing, painting, drawing, singing, playing an instrument, and doing arts and crafts.|
Ascend|to travel in an upward direction|Sam was able to ascend the corporate ladder because of his relationships with powerful executives.|
Ascendancy|a situation of power from which an individual can influence ordirect other individuals|Jim is an arrogant man who believes he has an ascendancy that allows him to order his wife around like a slave.|
Ascendant|rising in power, status, or influence|The king desperately looked for a way to fend off the ascendant regime rising to power.|
Ascension|a rise in status or physical position|The plane’s ascension took it from the landing strip far into the skies above the airport it called home for a few hours.|
Ascent|a path that leads upward|My legs were tired after I took the ascent to the cabin on the ridge.|
Ascertain|learn or discover with certainty; determine|Detective Jimmy was able to quickly ascertain the suspect was not being honest with him.|
Ascetic|leading a life of self-discipline and self-denial, usually for spiritual reasons|Jacob chose to live an ascetic life because of his strict religious beliefs.|
Ascribe|attribute a cause or characteristic|While you can sometimes ascribe these symptoms to allergies, I’m pretty sure you have a full-fledged cold.|
Aseptic|free from living germs that cause disease|After undergoing extensive surgery, Karen’s bloodstream became aseptic which would label her as healthy.|
Ashamed|embarrassed because of one’s own actions|Ashamed of the lies she told her husband, the cheating wife hung her head in shame.|
Ashore|the land along the edge of a large body of water|The passengers went ashore once the cruise line made their scheduled stop in Florida.|
Aside|out of the way; to the side|Placing all problems aside, Lila decided to give her boyfriend a second chance.|
Asinine|very stupid or foolish|How asinine of you to pay for a television in pennies!|
Askance|with doubt or suspicion|The wealthy man looked askance as the gang members approached him.|
Askew|tilted to one side; in a crooked position|I’ve tried straightening out the poster three times, but it still looks askew.|
Aspect|a specific part of something|The critic’s review was single-minded and focused only on one aspect of the film.|
Aspects|parts of something|As we toured the home, I mentioned that the aspects of house were not my style.|
Asperity|harsh manner or tone of voice|When I was a teenager, my father used asperity when he spoke with all my dates in hopes of scaring them away.|
Aspersion|a false charge meant to harm someone’s reputation|Jack’s political rival cast an aspersion against him right before the election.|
Asphyxiate|to stop the flow of air to a person’s lungs by obstructing their breathing pathway|Detective Jones realized the killer did asphyxiate the victim by wrapping a belt around her throat and pulling it as tight as possible.|
Asphyxiation|the act of restricting oxygen to the brain in someone or something|Due to the red marks around her neck and her pale blue skin, the medical examiner determined that the woman died of asphyxiation.|
Aspirant|a person or group that strives to achieve something, take on a certain career, or follow a particular path|Though she didn’t possess much natural talent, the aspirant practice dancing every single day in hopes that she would be good enough to become a professional dancer.|
Aspirate|a medical term that means to draw in something by suction|During the science experiment, students tried to aspirate some of the excess liquid from the bowl using a syringe.|
Aspiration|a dream of accomplishing something|My husband and I share the aspiration of having a marriage that lasts a lifetime.|
Aspire|to hope or dream|Even though he claims that he doesn’t aspire to greatness, I have never seen anyone work the media the way that he does.|
Assail|to attack violently|If anyone ever talks negatively about Alex’s father, his response is to assail the person with insults.|
Assailant| an individual who attacks another individual|I was able to give the police a detailed description of the assailant who attacked me in the parking lot.|
Assassinate|to murder a famous or otherwise important person with a surprise attack|The murder only spent a few hours planning the killing, but was able to assassinate the politician right outside his home.|
Assault|a physical attack|An assault of the police officer left him bloody and battered.|
Assay|a test or assessment on something to determine what it contains|The laboratory conducted an assay to quantitatively measure the presence of ore in the composition.|
Assemblage|an assembly or collection|An assemblage of rust-colored antiques lined the tables of the thrift store.|
Assemble|to put together|The chef needed to assemble the ingredients for the meal.|
Assembly|construction|Toys R Us hires workers whose sole work task is assembly of bikes and other buildable toys.|
Assent|to agree to something especially after thoughtful consideration|For a while, it seemed as if Karen was not going to assent to Jim’s marriage proposal.|
Assert|to express an opinion or fact in a confident manner|The lawyer will assert his client’s innocence despite the overwhelming evidence against him.|
Assertion|a bold declaration without proof|The lawyer’s assertion will have us believe her client was not in the state at the time of the murder.|
Assertive|boldly self-assured; confident without being aggressive|The flight attendant became assertive when confronting the man who took his seat belt off during takeoff.|
Assess|to judge or evaluate the state or value of something|The field test will assess the police candidate’s ability to perform under stress.|
Assessment|the process of making a judgement or evaluation about someone or something|The assessment of my car damage was that it was totaled from the accident.|
Asset|an individual, quality, or thing that is considered valuable|Jane’s ’67 Mustang is her favorite asset.|
Asseverate|to state in a definite manner|The teacher could not believe the class mischief-maker had the nerve to asseverate a zombie stole his homework.|
Assiduous|showing hard work and care that is brought about by attention to detail|That was very assiduous of you to finish those financial reports weeks ahead of schedule.|
Assign|to designate or set apart something for some purpose |The store managers will assign daily duties to the seasonal employees.|
Assignation|an appointment or date to meet someone in secret, typically between lovers|I had an assignation with my girlfriend yesterday, the two of us sneaking out into town so our parents wouldn’t know what we were doing.|
Assignment|a particular task or duty that one is expected to complete|On assignment for the Washington Post, the reporter combed the city in search of information.|
Assimilate|to learn something so that it is fully understood and can be used|Because I am not good with math, I find it difficult to assimilate most of the geometry formulas.|
Assist|a helpful action or act of giving |I’m always willing to assist the elderly across the street when I see they’re struggling.|
Assistance|help; aid|The doctor called for assistance and the nurse came running.|
Assistant|a worker who helps in a particular field for task|Each library assistant was given a specific section of the library to put away books.|
Assisted|helped; aided|The kindergarten teacher assisted the children with tying their shoes and opening their milk cartons.|
Associate|to connect things in one’s mind|Even my two year old niece can associate the yellow arch with McDonald’s cheeseburgers.|
Association|a group of people organized for a particular purpose or mission|The association was created to help struggling veterans find housing and work.|
Associative|having a connection between two things|Research studies have shown time and time again that there is an associative connection between smoking and cancer.|
Assonance|the duplication of similar or identical vowel sounds in sentences, phrases, or words|If you find yourself repeating vowel vibrations in your poems, you’re probably making use of assonance in your rhymes.|
Assortment|a diverse collection of things or people|As she ventured into the closet, the maid was amazed by the assortment of shoes that lined the shelves.|
Assuage|to provide relief; causing to feel better|In an effort to assuage angry customers, the store issued everyone a full refund.|
Assuage|to relieve or ease unpleasant feelings|Darren tried to assuage his wife’s fear of flying by buying her a drink and holding her hand during takeoff.|
Assume|to suppose to be true, especially without proof|If I saw a man dressed all in black, holding a gun, and walking toward me, I would assume that the man is really a dangerous guy and I would run away from him.|
Assumption|the act of assuming, or taking to or upon one's self; the act of taking up or adopting|When the young woman became engaged, the assumption of wedding planner was taken on by the bride’s mother.|
Assurance|a promise that relieves doubt|In his address, the president will provide the public with an assurance the economy is slowly improving.|
Assure|to promise or guarantee|Unions are able to assure workers certain protections and benefits not guaranteed in nonunion states.|
Assured|guaranteed; promised|The dog groomer assured the dog’s owner that she would be satisfied with the pet’s haircut.|
Asterisk|a print symbol used for numerous purposes including highlighting something or signaling a note is included at the end of a page |As Tim studied his notecards, he put an asterisk beside any information he felt he needed to revisit.|
Asteroid|a rocky object that is smaller than a planet that most often orbits a star|Believing that an asteroid would one day strike the Earth, the citizens decided to live on Mars.|
Asthenosphere|the portion of the mantle of the Earth that rests under the lithosphere and is comprised of rocks that can be altered in shape|The asthenosphere is an underlying layer of the Earth positioned beneath the lithosphere.|
Astir|in motion|By dawn of Christmas Day, the excited children were already astir.|
Astonish|to trigger surprise or wonder|Hopefully the magic show will astonish our guests and leave them amazed.|
Astonished|greatly surprised or amazed|After weeks of studying the Civil War, Kevin was astonished with his below average grade on his history test.|
Astonishing|causing amazement|The magic show was an astonishing display of illusions and wonder.|
Astound|to overpower with amazement|The taste of the wonderful dessert is sure to astound anyone who likes chocolate.|
Astral|related to the stars|A telescope is being used to look at stars and other astral objects in the sky.|
Astray|not on the desired path|My partying friends tried to lead me astray from my studies.|
Astride|with ones legs on either side of |An old portrait of Molly shows her sitting astride a horse.|
Astringent|acidic|The sauce was way too astringent for my taste, as I dislike bitter flavors.|
Astrology|the study of the movements and positions of the planets and stars and how they might affect our lives|Because she followed astrology, she read her horoscope each day.|
Astute|marked by practical hardheaded intelligence|The astute businessman went from rags to riches with one great idea.|
Asunder|separate into distinct parts|When I learned my husband had been cheating on me, I felt as though my world had been blown asunder.|
Asylum|place of safety|Clara’s lifelong dream is to start a program that grants asylum to persecuted citizens from other countries.|
Asymmetrical|having two uneven or crooked sides|I have asymmetrical eyes, with one eye bigger and lower than the other.|
Asymptomatic|displaying no signs or symptoms of illness| Although the doctor says I have a heart condition, I’m currently asymptomatic and feel fine.|
Asynchronous|not happening or occurring at the same time|The online course was asynchronous, allowing students to learn at their own pace.|
Atheism|a lack of belief in the existence of a God or gods|The man’s atheism was a surprise to his family members who were devout Catholics and wholeheartedly believed in God.|
Athlete|a person who is proficient in sports and other forms of physical exercise|The ballet dancer raged when people scoffed and said that she wasn't an athlete because she spent as many hours training as NFL players.|
Atlas|a book of maps|Containing 40 maps, the atlas showed various boundaries between countries and states.|
Atmosphere|the climate or mood in a certain place|The atmosphere in the party was very festive.|
Atmospheric|relating to the atmosphere (air that surrounds the Earth.)|Global atmospheric levels of the gas continue to rise throughout the world’s air.|
Atom|the smallest portion of an element that contains the chemical traits of the element|Water consists of two hydrogen atoms and one oxygen atom.|
Atomize|to reduce something into small particles or a fine mist|When scientists atomize a solution into tiny bits, an aerosol spray is created.|
Atone|to reimburse for a wrongdoing|To atone for racist actions in his youth, the billionaire established a scholarship fund for minority students attending his alma mater.|
Atrabilious|bad-tempered or irritable|The pupils were afraid to ask the atrabilious teacher questions.|
Atrocious|heinous; monstrous|After receiving atrocious reviews, the play closed the day after opening.|
Atrocity|a horrific action|The atrocity of the murders stunned the entire city.|
Atrophy|to weaken in ability or function|It was hard to watch my mother atrophy as she experienced the weakening disease of Alzheimer’s.|
Attach|to tie or connect something to something else|The student will attach a lock to his locker to keep other students from stealing his things.|
Attached|tied or connected something to something else|At the airport, the clerk attached a piece of paper with our names on it to our luggage.|
Attack|aggressive or violent action|The attack took place in the middle of the street and frightened many people watching the fight.|
Attain|to accomplish; to achieve|Linda can not attain peace of mind until she finds her missing dog.|
Attainment|the act of gaining something by working for it|For Phillip, one of the proudest achievements of his life was the attainment of his medical degree.|
Attempt|to try; make an effort|Hoping that they could attempt to save their marriage, the husband asked his wife to go to counseling.|
Attend|to go to an event or meeting|If you want to attend the sales conference, you must sign up online by Friday.|
Attendance|the number of people present at an event|Attendance at the concert was low because the ticket prices were so high.|
Attention|the concentration or awareness of something|Her attention to detail when she constructed the very thorough employee manual answered every question a new employee had.|
Attentive|observant; watchful|As a loyal husband, Barry is very attentive to the needs of his wife Drew.|
Attenuate|to reduce to a weaker or smaller state|Doctors claim taking the flu vaccine will attenuate the effects of the illness.|
Attest|to uphold something as real or true|As any police officer can attest, driving while texting is not safe.|
Attire|one's dress or clothes|The high school prom required formal attire, but no one was allowed to rent a limousine.|
Attitude|a person’s opinions or feelings about a specific thing, person, or idea|His positive attitude helped everyone enjoy the trip during the rainstorm.|
Attorney|a person appointed to act for another in business or legal matters|If you’re ever arrested, refuse to answer questions and ask to speak to an attorney.|
Attract|to cause something to be drawn towards something else|The sweet smell of the flower nectar can attract bees from many miles away.|
Attractive|good-looking; appealing|Although she found the handsome gentleman attractive, Christine wasn’t sure if she could date a younger guy.|
Attribute|a characteristic of something|If you want to be a nurse, being compassionate is one attribute you should have.|
Attribution|the act of assigning someone credit or acknowledgement for doing something|My book included an attribution to all those who edited the manuscript.|
Attune|to customize or modify something to be more receptive or capable|The radio transmitter wasn’t picking up what we needed, so I had to attune it to the right frequency.|
Atypical|not normal|Eating meat would be completely atypical for a vegetarian.|
Auction|public sales event|A vintage 1929 Mercedes Benz was sold at auction last week to an anonymous buyer.|
Audacious|recklessly bold; daring|Cooper was an audacious soldier who never ran from a battle.|
Audacity|a confident and daring quality that is often seen as shocking or rude|To everyone’s surprise, Jackie had the audacity to invite herself to her rival’s wedding.|
Audible|capable of being perceived|To block out audible sounds, Jack uses earplugs when flying.|
Audience|a group of viewers or spectators|Bowing gracefully in front of the audience, the ballerina beamed ear to ear as the attendees shouted for an encore.|
Audit|to conduct an independent review and examination of certain data |Before baking brownies, make an audit of the ingredients available to see whether there is enough flour, eggs, and sugar.|
Audition|to present talents in front of a judge or judges in order to achieve a desired position or role|Diana flew to New York to audition for the leading role of Eliza in Hamilton.|
Auditorium|a large room or building where people gather to watch a performance or hear a speech|The packed auditorium held almost a thousand concert-goers who were eagerly awaiting the arrival of their idol.|
Auditory|of or pertaining to hearing|Many people are auditory learners who learn best through hearing.|
Aught|anything or for all|My psychiatrist says I worry too much, but for aught I know, a stranger could be watching all of my actions.|
Augment|to increase the size or amount of something|Because I want to augment my income, I am thinking about getting a second job.|
Augur|to predict what is yet to come |Even the film’s initial reviews augur the movie’s A-list cast will be front and center on Oscar night.|
Augury|a prediction or omen|There are those who view the virus as an augury of the world coming to an end.|
August|much-admired and respected|Everyone wanted the chance to dine with the august president.|
Aural|pertaining to the ear or the sense of hearing|Instead of using his eyes to read the book, the truck driver used his aural sense to listen to the contents of the novel.|
Auricular|of or relating to the ear or the sense of hearing|After getting hearing aids, Grandpa Taylor realized he had fixed his auricular deficiency.|
Auriferous|describes rocks or minerals that contain gold|Placing his hands on the auriferous treasure, the pirate lusted for the golden trinkets.|
Auspices|guidance and support|Under the auspices of their commander-in-chief, the troops crossed the border into the war zone.|
Auspicious|being a sign of future success; indicating a promising future|His brilliant acceptance speech was an auspicious start to his political career.|
Austere|without any decoration; strict and serious in manner|Even though she appeared austere, my teacher was a very kind woman.|
Authentic|genuine; real; unfaked|We went to an authentic Mexican restaurant for my birthday where they served cuisine like you would find in Mexico.|
Authenticate|to prove that something is true or genuine|We will need to authenticate your orders to make sure that they did indeed come from high command before we can let you past this point.|
Author|someone who writes books for a living|Theodor Seuss Geisel was a famous author who published over sixty children’s books bearing the name Dr. Seuss.|
Authoritarian|preferring or enforcing strict obedience to authority as opposed to individual freedom|Our teacher is very authoritarian in her management and doesn’t allow us any wiggle room on the rules.|
Authoritative|having an attribute that encourages people to obey you|The principal has such an authoritative presence that even rebellious students behave around him.|
Authority|the power to enforce rules or give orders|Because I am the manager, I have the authority to change the policy at my job.|
Authorize|to give official permission|A manager must authorize the transaction before we can give the customer the money.|
Authorship|the job of written composition |In the Bible, the authorship of Revelations is believed to be drafted by John the Apostle because there is evidence that he wrote it.|
Autobiography|the story of an individual’s life written by that individual|To learn about the deceased celebrity, you should read the autobiography he wrote about his life.|
Autochthonous|original inhabitants of a place without any migration or intermingling of other groups|Many autochthonous tribes in remote corners of Siberia have never been approached by colonists or married outside of their group.|
Autocracy|a government type in which one person has boundless power|The country is an autocracy that is controlled solely by a member of the royal family.|
Autocrat|an individual who rules without considering others|The corrupt autocrat views the brutal dictator as a role model.|
Autocratic|not concerned about the wishes or opinions of others; heavy-handed|The autocratic dictator ordered the deaths of people who opposed him.|
Autodidact|self-taught person|After moving to the rural village of the Congo, the autodidact learned math and science due to the only school being over one hundred miles away.|
Autograph|a person’s own handwriting, especially the signature of a famous or admired person|In order for the check to be valid, Greg needed to include his autograph.|
Automated|controlled by a machine rather than a person|If you call the hotline, you will talk to an automated system instead of a real person.|
Automatic|something that is automated, or acts of its own accord without conscious effort or input|A car with an automatic transmission will shift gears appropriately while driving, without any input from the driver themselves.|
Automatically|spontaneously and involuntarily|As I inhaled dust when I shook the dirty rug, I automatically sneezed without any warning.|
Automation|the process of making a machine or system work without having to be controlled by a person|Automation of the cotton picking process through the creation of the cotton gen changed the south forever.|
Automotive|pertaining to a car or other powered automobile|After wrecking my car at the intersection, I took my damaged Honda Accord to the automotive center for repairs.|
Autonomy|the quality or state of being self-governing|Teenagers should have the autonomy to make their own decisions in preparation for their lives as adults.|
Autopsy|dissection of a body after death that is conducted to determine how the person died|An autopsy of the deceased was performed against the family’s wishes since neglect was suspected.|
Autumn|the season between summer and winter; fall|Even though autumn is such a beautiful season, raking all of those leaves becomes such a daily chore for me.|
Auxiliary|a group or team that provides assistance|When my grandmother retired, she joined the hospital auxiliary team that visited lonely patients.|
Avail|to be of advantage or use|Stranded in the desert, Jake tried to restart his car but to no avail.|
Availability|having the time or means supplies to do something|The secretary informed the caller of her boss’s availability to meet that week.|
Available|accessible and obtainable|When my dream house was put on the market and appraised in my price range, I knew the house would be available for me to purchase it.|
Avalanche|an unexpected accumulation|During the power outage, our office faced an avalanche of distress calls.|
Avant-garde|cutting-edge; trendy|The elderly poet was confused by the youth’s avant-garde style of writing.|
Avarice|A strong desire and greed for money/material things|Mr. Krab’s avarice for money caused him to work his employees to the bone for little pay.|
Avaricious|desirous of wealth or advancement|Since Tiffany was an avaricious reader, her reading level was at 12th grade level even though she was still in 4th grade.|
Avatar|in technology, an icon or figure representing a particular person|In the hybrid chat room, an avatar is used in place of the person’s real picture.|
Avenue|a method or means by which something may be accomplished |Admittedly, anger is an all too human response to frustration; but it's still no avenue to solid achievement.|
Aver|to assert something in a convincing way |Even though the country is in an economic crisis, its leader will aver the nation is doing well during his monthly address.|
Average|ordinary; not very special|Although others thought the woman to be very beautiful, she was insecure and only saw herself as average.|
Averse|actively not liking something|For those who are averse to spaghetti, you also have the meal choice of baked chicken with roasted potatoes.|
Aversion|a feeling of disgust toward something with a desire to avoid it|Older people who are unfamiliar with computer technology often have an aversion to it.|
Avert|to stop an incident from occurring|I always avert my eyes to avoid seeing the bloody movie scenes.|
Avian|relating to birds|The avian part of the animal kingdom includes every type of bird there is, from the flightless penguin to the majestic eagle.|
Aural|pertaining to the ear or the sense of hearing|Instead of using his eyes to read the book, the truck driver used his aural sense to listen to the contents of the novel.|
Auricular|of or relating to the ear or the sense of hearing|After getting hearing aids, Grandpa Taylor realized he had fixed his auricular deficiency.|
Auriferous|describes rocks or minerals that contain gold|Placing his hands on the auriferous treasure, the pirate lusted for the golden trinkets.|
Auspices|guidance and support|Under the auspices of their commander-in-chief, the troops crossed the border into the war zone.|
Auspicious|being a sign of future success; indicating a promising future|His brilliant acceptance speech was an auspicious start to his political career.|
Austere|without any decoration; strict and serious in manner|Even though she appeared austere, my teacher was a very kind woman.|
Authentic|genuine; real; unfaked|We went to an authentic Mexican restaurant for my birthday where they served cuisine like you would find in Mexico.|
Authenticate|to prove that something is true or genuine|We will need to authenticate your orders to make sure that they did indeed come from high command before we can let you past this point.|
Author|someone who writes books for a living|Theodor Seuss Geisel was a famous author who published over sixty children’s books bearing the name Dr. Seuss.|
Authoritarian|preferring or enforcing strict obedience to authority as opposed to individual freedom|Our teacher is very authoritarian in her management and doesn’t allow us any wiggle room on the rules.|
Authoritative|having an attribute that encourages people to obey you|The principal has such an authoritative presence that even rebellious students behave around him.|
Authority|the power to enforce rules or give orders|Because I am the manager, I have the authority to change the policy at my job.|
Authorize|to give official permission|A manager must authorize the transaction before we can give the customer the money.|
Authorship|the job of written composition |In the Bible, the authorship of Revelations is believed to be drafted by John the Apostle because there is evidence that he wrote it.|
Autobiography|the story of an individual’s life written by that individual|To learn about the deceased celebrity, you should read the autobiography he wrote about his life.|
Autochthonous|original inhabitants of a place without any migration or intermingling of other groups|Many autochthonous tribes in remote corners of Siberia have never been approached by colonists or married outside of their group.|
Autocracy|a government type in which one person has boundless power|The country is an autocracy that is controlled solely by a member of the royal family.|
Autocrat|an individual who rules without considering others|The corrupt autocrat views the brutal dictator as a role model.|
Autocratic|not concerned about the wishes or opinions of others; heavy-handed|The autocratic dictator ordered the deaths of people who opposed him.|
Autodidact|self-taught person|After moving to the rural village of the Congo, the autodidact learned math and science due to the only school being over one hundred miles away.|
Autograph|a person’s own handwriting, especially the signature of a famous or admired person|In order for the check to be valid, Greg needed to include his autograph.|
Automated|controlled by a machine rather than a person|If you call the hotline, you will talk to an automated system instead of a real person.|
Automatic|something that is automated, or acts of its own accord without conscious effort or input|A car with an automatic transmission will shift gears appropriately while driving, without any input from the driver themselves.|
Automatically|spontaneously and involuntarily|As I inhaled dust when I shook the dirty rug, I automatically sneezed without any warning.|
Automation|the process of making a machine or system work without having to be controlled by a person|Automation of the cotton picking process through the creation of the cotton gen changed the south forever.|
Automotive|pertaining to a car or other powered automobile|After wrecking my car at the intersection, I took my damaged Honda Accord to the automotive center for repairs.|
Autonomy|the quality or state of being self-governing|Teenagers should have the autonomy to make their own decisions in preparation for their lives as adults.|
Autopsy|dissection of a body after death that is conducted to determine how the person died|An autopsy of the deceased was performed against the family’s wishes since neglect was suspected.|
Autumn|the season between summer and winter; fall|Even though autumn is such a beautiful season, raking all of those leaves becomes such a daily chore for me.|
Auxiliary|a group or team that provides assistance|When my grandmother retired, she joined the hospital auxiliary team that visited lonely patients.|
Avail|to be of advantage or use|Stranded in the desert, Jake tried to restart his car but to no avail.|
Availability|having the time or means supplies to do something|The secretary informed the caller of her boss’s availability to meet that week.|
Available|accessible and obtainable|When my dream house was put on the market and appraised in my price range, I knew the house would be available for me to purchase it.|
Avalanche|an unexpected accumulation|During the power outage, our office faced an avalanche of distress calls.|
Avant-garde|cutting-edge; trendy|The elderly poet was confused by the youth’s avant-garde style of writing.|
Avarice|A strong desire and greed for money/material things|Mr. Krab’s avarice for money caused him to work his employees to the bone for little pay.|
Avaricious|desirous of wealth or advancement|Since Tiffany was an avaricious reader, her reading level was at 12th grade level even though she was still in 4th grade.|
Avatar|in technology, an icon or figure representing a particular person|In the hybrid chat room, an avatar is used in place of the person’s real picture.|
Avenue|a method or means by which something may be accomplished |Admittedly, anger is an all too human response to frustration; but it's still no avenue to solid achievement.|
Aver|to assert something in a convincing way |Even though the country is in an economic crisis, its leader will aver the nation is doing well during his monthly address.|
Average|ordinary; not very special|Although others thought the woman to be very beautiful, she was insecure and only saw herself as average.|
Averred|stated something that was true and accurate|The witness averred that he had seen the suspect run away with the cash and sealed the man’s fate with his damning testimony.|
Averse|actively not liking something|For those who are averse to spaghetti, you also have the meal choice of baked chicken with roasted potatoes.|
Aversion|a feeling of disgust toward something with a desire to avoid it|Older people who are unfamiliar with computer technology often have an aversion to it.|
Avert|to stop an incident from occurring|I always avert my eyes to avoid seeing the bloody movie scenes.|
Avian|relating to birds|The avian part of the animal kingdom includes every type of bird there is, from the flightless penguin to the majestic eagle.|
Aviary|confinement for keeping birds; a birdhouse|The cockatiel breeder used a suspended aviary to breed new birds.|
Aviation|the activity of designing, producing, or flying an aircraft|The top-notch aviation school only allows students with the highest potential to join its pilot program.|
Aviator|a pilot|The aviator prepared for his first flight across the Pacific by checking his engine and fueling his aircraft.|
Avid|enthusiastic; passionate|James is an avid supporter of any organization that is trying to improve the environment.|
Avidity|a strong eagerness or desire|The journalist’s avidity to learn everything there is to know about the case drove her to work long hours.|
Avidly|in an excited or enthusiastic manner|Airport police became suspicious of a passenger after one of the drug dogs avidly sniffed his carry-on bag.|
Avocation|an activity one enjoys when he or she is not working|Recently, Sherman discovered woodworking is the type of avocation he enjoys in his spare time.|
Avoid|to keep away from; dodge or evade|The dieter tries to avoid foods that are high in fat or sugar.|
Avoidable|able to be stopped or prevented|Diabetes can be avoidable if you reduce your sugar intake and exercise regularly.|
Avoidance|the act of staying away from someone or something|The procrastinator’s therapist tried to explain that avoidance of a task doesn’t make it disappear.|
Avoirdupois|a system in the United States for measuring a pound equaling to sixteen ounces|To calculate the weight of the gold using avoirdupois, it was determined that the gold weighed over a pound.|
Avouch|to declare freely and openly; to assert|Standing at the witness stand, I stated that I could avouch for the sterling reputation of Jennifer.|
Avow|to admit or confess something publicly|Because the man would not avow himself as a follower of the king in front of the villagers, he was sentenced to death.|
