Exhibitionist|an individual who uses his or her behavior to catch peoples’ attention|The female rapper is an exhibitionist who attracts attention by wearing revealing clothing.|
Exhilarate|to make an individual extremely happy|Achieving my weight loss goal is sure to exhilarate me.|
Exhilarating|producing intense feelings of joy or excitement|When I won ten million dollars in the lottery, it was the most exhilarating moment in my life.|
Exhort|to strongly urge someone to do something|While I cannot force you to drive the speed limit, I exhort you to do so or else you might end up in jail.|
Exhume|to bring something forth, often a body from the ground|When new evidence was introduced, the detective chose to exhume the elderly woman’s body.|
Exigency|something that is necessary in a particular situation|Rules are an exigency inside of a prison or else chaos will reign.|
Exigent|urgent; needing immediate action|The police should always obtain a search warrant unless there is an emergency or exigent circumstances.|
Exiguous|a tiny quantity of something or a tiny height|Due to my exiguous knowledge of history, I was bound to lose quickly at the history trivia game.|
Exile|the state of being expelled from one's country or home|The military leader was forced into exile and spent his final days on a small island.|
Eximious|exceptional; distinguished|Not willing to settle on the venue, the bride looked for an eximious location that would top any other she had seen.|
Existence|something determined to be real |Skeptics finally believed in the existence of ghosts once the paranormal activities were detected in their house.|
Existent|to be living|Questions are always posed about whether the dinosaurs were existent after the Mesozoic Era.|
Existential|something relating or dealing with existence|Perhaps the most existential question is “what is the meaning of life?”|
Exit|to go away or leave a place|Once the movie is over, the patrons will exit the theater and get in their cars to go home.|
Exodus|a situation in which a lot of people leave a place or activity at the same time|One would think that the repeated occurrence of tornadoes in an area would prompt an exodus of the residents to a location with a more stable climate.|
Exogamy|marrying someone from a different communal group|In order to avoid marrying a relative, the tribe practiced exogamy which involved mostly the surrounding tribes.|
Exogenous|caused by outside factors|The doctor determined that the woman’s depression was exogenous and stemmed from weather changes and other outside factors.|
Exonerate|to prove that someone is not guilty of a crime or responsible for a problem, bad situation, etc.|The job of the defense attorney is to exonerate his clients and keep them out of jail.|
Exonerated|to declare someone not guilty of criminal charges|After being exonerated, the death row inmate was freed from his jail cell.|
Exorbitant|unreasonably high amount of something; too much|The luxury hotel charges an exorbitant rate of $25 for a single cheeseburger.|
Exorcise|to drive out an evil spirit from a person, place or thing, especially by an incantation or prayer|Many people turn to religion to exorcise themselves from sin.|
Exorcism|the act of driving out a demon from a person or place|During the Second World War, some believed Adolf Hitler was possessed by a demon and tried to remove it through a long-distance exorcism.|
Exordium|the introductory part of a speech|The exordium of the speech explained the reasons why the speaker had selected nursing as a career.|
Exoskeleton|a hard outer body that covers and protects certain animals, particularly insects|Bats love to eat a certain type of insect, but cannot digest its hard exoskeleton.|
Exothermic|releasing heat|Because it generated heat, the chemical was considered exothermic.|
Expand|to increase in size or enlarge|In order to expand the master bedroom, the owner tore through a wall to combine the bedroom and a bonus room.|
Expanse|an open area that is large in size|The city park is a beautiful expanse of green in the center of town.|
Expansion|growing larger or more extensive|Expansion into the western part of the United States increased after a huge land deal was struck with the French.|
Expansive|covering a wide area; extensive|Covering an expansive area, the search team looked high and low for the missing child.|
Expansively|having a wide range or extent of effect or influence|The company has an expansively built network of cell phone towers to help them provide their service to as many people as possible.|
Expatiate|to write or talk about something using many details|During his book signing, Clark will expatiate on his military adventures.|
Expatriate|an individual who does not reside in his native nation or birthplace|My uncle is an expatriate who left the country of his birth to live in France.|
Expect|to guess or suppose|When everything was going wrong with the flight, we were told to expect the worst with a crash landing.|
Expectancy|in a state of hoping or expecting something to happen|Right before the storm, the stores restocked their shelves with expectancy of hurried shoppers.|
Expectant|waiting eagerly for something to happen|Impatiently waiting for her newborn’s arrival, the expectant mother counted down the days until her due date.|
Expectation|a belief that something is going to happen in the near future|The expectation that a landslide victory would occur was confirmed during the election with seventy percent of the vote going to the incumbent.|
Expectorate|to expel from the mouth|If Jack wants to feel better, he needs to expectorate the mucus from his lungs.|
Expedient|suitable to the circumstances; appropriate|Given the fact the police will be looking for us soon, it is expedient we leave this apartment quickly!|
Expedite|to cause something to happen faster|If you would like to expedite the shipping of your order, please pay the express shipping fee.|
Expedition|a trip taken for a specific reason|In the television series, the spaceship set off on a ten-year expedition to explore new planets and meet new life forms.|
Expeditious|performed quickly and efficiently|When I order fast food, I expect to receive it in an expeditious timeframe.|
Expel|to force something out such as liquid and air; eliminate|When Susan was sick with bronchitis, the doctor told her to cough up the mucus and immediately expel it.|
Expend|to use up|Our long, midday hike always causes me to expend all of my energy and leaves me exhausted by dinner.|
Expense|a cost or price|Although the dealership agreed to repair the motor for free, the owner had to purchase a battery at an added expense.|
Experience|knowledge or skill gained by doing|The woman’s previous management experience made her a shoe-in for the leadership position at a local factory.|
Experiential|knowledge gained from experience and observation|Taking an experiential approach, the company hoped to train employees through hands-on training modules.|
Experiment|an examination usually in a scientific nature that tests a proposed explanation|The scientists conducted an experiment on rats to determine if the new medication is safe for people.|
Experimental|something new that is still in the trial stages|Experimental trials provided encouraging results related to new chemotherapy options for cancer patients.|
Expert|an expert is someone specialized in a given area|As an expert in natural healing, the naturalist provides nutritional advice to cure diseases.|
Expertise|the knowledge held by one who is an expert in something|Kurt’s computer expertise earned him a high-paying job.|
Expiate|to make up for something|To expiate for breaking his neighbor’s window, John shoveled snow for three months.|
Expire|for something, most often a period of time, to end|My contract with the client I work for is set to expire in six months, after which I’ll need to find a new source of work.|
Explanation|a description of something or someone in order to clarify it|When the new employee was going through her job orientation, the boss provided an explanation of the tasks she would need to perform.|
Explanatory|the act of describing something|Mr. Doug’s secretary emailed her department an explanatory memo about what should be in the quarterly reports.|
Explicable|capable of being justified or recognized as true|The only explicable solution to the water shortage problem was to simply conserve as much water as possible.|
Explicit|specific about rules or what is required|The difficult woman left the maid explicit details about how she wanted her house cleaned.|
Explode|to blow up something using a violent and noisy tactic|The Los Angeles Bomb Squad detonated the mysterious device before it would explode and damage everything in sight.|
Exploit|to gain an advantage by doing something unethical |For hefty paychecks, the paparazzi were willing to exploit the grieving widow at her husband’s funeral.|
Exploited|utilize someone or something for their own personal gain|“Jane exploited the situation,” Karen responded, “since she only came to our party to eat dinner.”|
Exploration|adventuring into an unknown place in order to become educated about it|Several kids decided to conduct an exploration of the cave due to their curiosity of science.|
Exploratory|associated with searching and examining something|For my technical writing class, I decided to conduct exploratory research to narrow down my topic for my next paper.|
Explore|travel to or examine|Setting out to explore the island was the most adventurous thing the man had ever done.|
Explorer|an adventurer that explores unfamiliar areas or uncharted territories|Looking for the West Indies, the explorer must have been surprised when he ended up on a completely different continent than what he set sail for.|
Explosion|a violent blowing apart or bursting caused by a chemical change|The dynamite detonated, causing an earth shattering explosion across the city.|
Explosive|something that explodes or blows up when ignited|Fearing her husband’s explosive personality, the wife tried to speak softly and avoid any topics that would infuriate him.|
Exponent|an individual who champions a certain principle or cause; an advocate|Once homeless Janice is now a successful businesswoman and exponent for ending homelessness.|
Exponentially|increasing rapidly in a sizable quantity|Because of the poor economy, crime has increased exponentially in our state.|
Export|to send to another nation for retail purposes|If the country did not have oil to export, it would be a very poor nation.|
Expose|to reveal or uncover something|The blackmailer threatened to expose the politician’s love child.|
Exposition|the action of putting something out to public view; for example, in a display or show|We attended a Business to Business exposition, where exhibitors displayed their products and services to attract other companies.|
Expostulate|to express strong disagreement|My mother never missed the opportunity to expostulate her opinion anytime my father did something which displeased her.|
Exposure|unprotected or visible to others|Exposure to ultra-violet rays from the sun can lead to skin cancer, so it is necessary to cover yourself with sunscreen.|
Expound|to clarify by providing details|During his graduation speech, Thad will expound his hopes and prayers for his graduating class.|
Express|communicate; articulate|Meteorologists began to express their concern about a storm moving into the area.|
Expression|the look on one’s face that shows what he or she is feeling|Looking at the excited expression on her daughter’s face, Donna was happy that she could make her little girl’s dreams come true.|
Expressive|animated; dramatic|The expressive dance routine was added to the boring show to give an animated touch.|
Expressly|specifically; clearly|The regulations for entry are expressly and clearly stated in the rulebook.|
Expropriate|to take away property without payment to the owner|The pirate’s made their living by being able to expropriate the property of others they happened upon.|
Expulsion|a circumstance in which an individual or thing is ejected from a position, place, or group|Since Henry hated school, the threat of expulsion did not make him behave.|
Expunge|to remove completely|I would like to expunge my ex-husband from my memory.|
Expurgate|to edit out rude, incorrect, offensive, useless, or otherwise undesirable information; to purge|The rapper was told that if he did not expurgate the offensive lyrics from his new song, it would never be played on the radio.|
Exquisite|especially fine or pleasing; exceptional|She wore an exquisite dress, which left all the guests staring in surprise.|
Extant|still around; not extinct|The extant writings of the ancient philosopher are still quite popular with philosophy students.|
Extemporaneous|completed without any type of advance preparation|Instead of giving his prepared speech, the minister delivered an extemporaneous statement about the recent terrorist attacks.|
Extempore|impromptu; done without preparation|An extempore meeting was called without notice to terminate employees who hadn’t lived up to performance standards.|
Extemporize|to improvise, especially while giving a speech or performing music|The pianist was able to extemporize and play a piece without music or preparation.|
Extend|to move outward|The procrastinating students requested for the professor to extend the deadline for the essay.|
Extension|the act of moving something outward|Since the plug was across the room, Toby needed an extension so the cord could reach his computer.|
Extensive|having a large scale|It will take several months for the city to clean up the extensive damage caused by the hurricane.|
Extensively|to a large degree|Having toured the area extensively, the man felt that he had a lot of background knowledge on what was needed in Amsterdam.|
Extent|the distance or magnitude something spreads or covers|No one knew the extent of her son’s injury since the school only gave minute details of what happened on the playground.|
Extenuate|to cause a wrong act to be judged less harshly because of circumstances|The woman’s troubled childhood wasn’t enough to extenuate or excuse her of killing her husband.|
Extenuating|to lessen the seriousness of a wrong act|The court reduced the criminal’s sentence because of extenuating circumstances.|
Exterior|pertaining to the outside of something|When I noticed the chipped paint on the exterior of my house, I hired a professional to paint the outer part of my house.|
Exterminate|to destroy completely|Needing help to exterminate the bugs, the pest control worker ordered specialized repellant.|
External|the exterior or outside of something|When the two children continued to physically fight, this external conflict would cause their parents to get tired of hearing the bickering.|
Extinct|no longer active or in existence|Even though dinosaurs are extinct, people can learn more about them by visiting a museum.|
Extinction|the process of a species completely dying out|Extinction of the species happened after poachers killed many of the animals.|
Extinguish|to snuff out or eliminate something|She learned that the only way to extinguish a grease fire is to eliminate the oxygen by covering it with another pan or pouring baking soda on top.|
Extirpate|to totally eliminate|Hopefully the pesticides will extirpate the insects from my garden.|
Extol|to praise|Because Helen and Gina were jealous of their sister’s good fortune, they did not extol her when she won the academic scholarship.|
Extort|to take from an unwilling person|When Larry was fired, he attempted to extort cash from his former boss by threatening to expose the man’s drug addiction.|
Extortion|the practice of obtaining money from someone through force, threats, or abuse of power|The criminal committed extortion when he threatened to hurt the victim’s family if she didn’t give him money.|
Extract|to pull an object from something in order to remove it, usually with force|When the dentist noticed the infected tissue around his patient's gums, he knew he would have to extract the tooth.|
Extraction|the process of removing something or taking it out|The man paid for the extraction of just one tooth but ended up having another one removed as well.|
Extradite|to send an individual accused of a crime back to the area in which the crime took place|The state will soon extradite Cal to the island nation where he is wanted for assaulting a young girl.|
Extraneous| not essential or coming from the outside|Because of so many extraneous details in the instructions, Dad wasn’t able to put the toy together in time for Christmas morning.|
Extraordinaire|someone or something that is outstanding or remarkable|That man is an extraordinaire, being someone that goes on remarkable adventures with his ludicrous amounts of cash.|
Extraordinary|amazingly good|Henry is an extraordinary pianist who has played for three presidents and several royal families.|
Extravagant|excessive; exceeding normal bounds|Rick spent nearly a year’s salary on the extravagant engagement ring.|
Extravaganza|excessive and lavish celebration or performance|Carnival in Venice, Italy, is an annual extravaganza of elaborate masks, dancing, music, and feasting before Lent.|
Extreme|to a very large degree or amount|Laura always takes arguments to the extreme and quickly turns things physical.|
Extremist|a person who holds radical views that are viewed as extreme or fanatical|Because they are an extremist group, ISIS has some very fanatical religious views.|
Extremity|a risky measure|Who would have ever thought Patrick would go to the extremity of jumping out of an airplane to propose to Michelle?|
Extricate|to free or remove something or someone |If the magician does not extricate himself from the water tank in the next forty-five seconds, he will die.|
Extrinsic|not belonging to, outside of|We did not expect there to be any issues with our wedding date, however the weather turned into an extrinsic factor that forced us to change the date.|
Extrovert|an individual who is sociable and enjoys conversing with others|Because Pat is an extrovert who enjoys chatting with others, she is the ideal talk show host.|
Extrude|to force out|The volcano began to extrude lava, shooting the hot liquid up and over its sides.|
Extrusive|describes rock material that was made when magma was pushed out through holes in the earth's surface|After the lava cooled extrusive slabs of rock were scattered around the outer edge of the volcano.|
Exuberance|the quality of being exuberant; cheerful or vigorous enthusiasm; liveliness|Even though the children’s choir had trouble getting the words of the songs right, their exuberance in singing more than made up for it.|
Exuberant|filled with energy and enthusiasm|Even though Johnny was not a very good basketball player, he had such an exuberant attitude that he came across as one of the stars of the team.|
Exudation|a condition of something quickly flowing out or forward|As the young man came dressed in a suit and presented himself professionally, the exudation of class was apparent to anyone who was in the same room with him.|
Exude|to openly display an emotion or quality|After accomplishing so much, he could not help but exude confidence in himself.|
Exult|to rejoice, be very happy|Christians are taught to exult Christ above all else.|
Exultation|a feeling of triumphant elation or jubilation|Harry’s feelings of exultation intensified as he neared the end of his prison term.|
Eyesore|an unpleasant or ugly sight that is in a public place (i.e. building, statue).|The casino was an eyesore to the community members who hated looking at the neon lights.|
Fable|a fictional tale, often with talking animals, meant to present a moral value|In the fable ‘The Tortoise and the Hare,’ we see that sometimes it is better to take things slow and steady if we really want to have success.|
Fabricate|to make up for the purpose of deception|The journalist got fired when his editor learned of his plan to fabricate a story about the president.|
Fabulist|a story-writer who composes or rewrites fables|The fabulist wrote tales about talking animals living long ago.|
Fabulous|amazing or wonderful|The amount of money we made during the fundraiser was absolutely fabulous, covering the cost of not only our current project, but the repaving of the school parking lot as well.|
Facade|deceptive outward appearance|I often find myself putting up a facade when I’m around my troubled brother.|
Face|the surface of (especially the front) of a thing|The face of the table had a scratch that ran all the way across the top.|
Facet|a side or aspect of something|“Beyond a reasonable doubt” means that you must explore every facet of the case.|
Facetious|joking often inappropriately; not serious|Do you always have to be so facetious?|
Facial|of or affecting the face|The actor read his lines and practiced his facial expressions in the mirror.|
Facile|easily performed|While the adults found the video game complicated, the teenagers thought it was facile and easily played.|
Facilitate|to make something occur or less difficult|The translator will facilitate the conversation between the immigrant and the attorney.|
Facilitation|the process of something becoming easier or simpler|Due to the teacher’s facilitation of the skills in her class, my grade jumped from making low D’s to A’s and B’s.|
Facility|space or equipment necessary to accomplish a task|There is no facility available to produce our cupcakes, so we will have to continue working from home.|
Facsimile|a copy or reproduction|He offered a facsimile of the original painting for a much discounted price.|
Fact|a truthful statement|My mother hid the fact that my dad was not my real father for more than forty years.|
Faction|a group within a larger group that has different ideas and opinions than the rest of the group|In the novel, the heroine was born into a faction of the population that dedicated their lives to helping each other.|
Factor|an element that contributes to a circumstance or situation|The high fuel consumption is the main factor that deters me from buying the vehicle.|
Factory|a building were products are made|Factory employees work Monday through Friday making the rubber stoppers that go in bathtubs.|
Factotum|person having many responsibilities|After accomplishing every task on the woman’s list from installing a new sink to babysitting the children, the factotum proved his worth and earned his pay for the day.|
Factual|having the quality or characteristic of being true or grounded in reality|That two plus two equals four is a completely factual statement, and no one can ever claim it to be false.|
Faculty|the teaching staff of an educational organization, such as a school or university|My favorite member of the faculty here at school is Mr. Earhart, because he teaches my favorite class.|
Faculty|the teachers who work at a school or university|Faculty pictures were included with the students in the school yearbook.|
Fade|a gradual decrease; dim movie clip or diminish sound|I don’t care for the speed sensitive volume control feature on my car because the music will fade when I come to a complete stop.|
Fahrenheit|a temperature scale in which 32 degrees is the standard for freezing and 212 degrees is the boiling point|If you crank the heat up to 212 degrees Fahrenheit, the water in the pot will begin to boil.|
Failure|a disaster or flop|The fashion show was a failure after the models fell off the runway, the lighting did not work and very few people showed up to watch the event.|
Fain|pleased or inclined to do something|Although I was on a diet, I was fain to eat a large slice of cake.|
Faint|weak and dizzy|Because she felt faint, the exhausted woman went to lie down for a while.|
Fair|just in decisions; right or ethical|The fair judge always made decisions that were in the reasonable and just.|
Fairness|the condition of being reasonable, impartial, and just|Many students loved their English teacher due to her fairness by treating each student equal to the other students.|
Fairway|an open path or space, particularly for playing golf|The golfer hit a tee shot over the water past the green fairway.|
Faithful|to be loyal to someone or something|After being caught in a small lie, the citizens remained faithful to the mayor since he had done so much good for their town and they could forgive a small lie.|
Fakir|a Muslim or Hindi holy man with magical powers who makes a living by begging|An Indian fakir roamed the city begging for alms from those who help the poor.|
Fallacy|an idea or belief that is false but many people think is true|Having money makes you happy is a fallacy because happiness has nothing to do with wealth.|
Fallen|having dropped by the force of gravity|I spent countless hours before winter begins raking leaves that have fallen from trees.|
Fallible|capable of making mistakes or being wrong|Even though we are all fallible to some degree, the most successful people have learned how to rise above their weaknesses.|
Fallow|not being used|At the end of summer, the once crowded beaches become fallow as the young people return to school.|
FALSE|untrue; fake|False news filled the internet, tricking people into believing lies.|
Falsehood|something that is an outright lie or fib|Despite the fact that Henry VIII told an obvious falsehood about his wife’s infidelity, the people of England were too scared to question the king and she was beheaded.|
Falsetto|an unnaturally high and feminine voice particularly sung by a male|The young man sang in a high, clear falsetto that rivaled the most talented female singers.|
Falsity|something that is false, an outright lie, or simply incorrect|A common historical falsity is that only Jews suffered under Hitler’s reign, but other marginalized groups were persecuted as well.|
Falter|to hesitate, stumble, or waver|When the bank teller noticed that the masked man began to falter slightly, she discreetly pressed the silent alarm.|
Familiar|to have knowledge of|Mia wasn't familiar with the astrophysics but after reading a few textbooks on the subject she learned quickly.|
Familiarize|to make, or become familiar with something or someone|Having just moved in, I walked around to familiarize myself with the neighborhood.|
Family|a group of people related to one another|All of the family members look alike because of their red hair and freckled faces.|
Famine|a severe food shortage or period when food is in short supply|Many people have starved to death because of the famine.|
Famish|to make someone extremely hungry|Three days without anything to eat was enough to famish the lost campers.|
Famished|extremely hungry|The man had not eaten for days, so when I asked if he was hungry he responded by saying “I’m famished.”|
Famous|well-known; famed|The chef became so famous for her meals that she was given her own cooking show.|
Fanatic|one who is extremely passionate about something, often a religion or cause |My husband is an exercise fanatic who runs six miles every day.|
Fanatical|having an extreme, irrational zeal or enthusiasm for a specific cause|Richard is fanatical about his beliefs, preaching to anyone that will listen.|
Fancied|liked or felt a desire for|The couple fancied a night out on the town, so they got dressed and called a cab.|
Fanciful|imaginative or unreal|Because she had a wild imagination, she loved to create fanciful stories in her spare time.|
Fanciful|coming from the imagination; dreamlike|The storyteller told fanciful tales about talking mermaids and fearless princesses.|
Fancy|to want to do something|We fancy a trip to the islands, but our budget won’t allow it.|
Fanfare|the attention of the public or prestigious ceremony|The President received a great deal of fanfare when he announced his plans on immigration, so the news spread word of it quickly.|
Fantastic|extraordinarily good; incredibly wonderful|The strong winds make for a fantastic day of kite flying.|
Fantastical|odd and remarkable; as if it came from the imagination|The woman’s real-life success story sounded like some fantastical movie plot.|
Fantasy|a pleasant thought of an unlikely enjoyable situation|When she was young, I often found my daughter Kendra in her room withdrawn into her own fantasy world.|
Farce|a ridiculous situation or event|Many argue that the government today is a mere farce of what it started out as.|
Farcical|bizarre or outlandish|Critics described the farcical play as an absurd piece of writing that could have only been created by an intoxicated playwright.|
Fare|the fee an individual is charged in order to be transported somewhere |The airline fare will set me back by eight hundred dollars.|
Farewell|goodbye to one who is departing|Tearful onlookers waved farewell to the departing soldiers heading to Afghanistan.|
Farfetched|unlikely; unbelievable|The idea that the losing team could come back and win was farfetched, but we held out hope.|
Farouche|wildly fierce while remaining unapproachable by others|The farouche canine growled and snarled as he backed away from those trying to capture it.|
Farrago|a collection containing a confused variety of miscellaneous things|The present gun law is a farrago of nonsense as most of it is unenforceable.|
Farther|referring to a larger physical distance|We have to walk farther than usual today because there was construction work on our usual route to school.|
Fascinate|to capture and hold someone’s attention or interest|The idea of a president that would strengthen the middle class seemed to fascinate those listening to the speech.|
Fascination|intense intrigue or interest in something|My fascination with the stars as a child led me to become an astronomer later in life, as I just love studying those stars and learning more about them.|
Fascism|a government that is ruled by a powerful dictator having control of everyone/everything|When the mayor discussed the possibility of a local curfew, the citizens immediately accused him of fascism.|
Fascist|related to a government system led by a dictator with complete power|The fascist regime has taken over the area and is ruling the city with an iron fist.|
Fashionable|popular; stylish|It took much persuading to convince my aunt that her bell-bottom jeans and platform shoes are no longer fashionable.|
Fast|moving at high speed or capable of high speed|People who love to go fast could experience no greater thrill than the supersonic flight of a fighter jet.|
Fasten|to make something secure or attached|Stuffing himself at the dinner table left the man unable to fasten his belt when he got up.|
Fastidious|concerned about accuracy and detail; hard to please|My mother was a fastidious woman who always had a complaint on her lips.|
Fatal|causes death or leads to a disaster|Dropping a fatal dose of poison into the goblet, the evil queen smiled down at her deathly elixir.|
Fatalist|one who maintains that all events have been predetermined, and that one cannot prevent things from happening|As a fatalist, the woman refused to believe that luck had anything to do with the events in her life.|
Fatality|death resulting from an accident or disaster|Fatality rates for motorcycle crashes is over 27 times that of automobiles.|
Fated|decided in advance; destined|Keith believes he is fated to have an alcohol addiction because his mother was an alcoholic.|
Fateful|important; momentous|Until the fateful meeting with Martin Luther King Jr., the activist never knew the impact of nonviolent protests.|
Fatherhood|the state of being a father to a child|Although he knew nothing about caring for children, the man threw himself into fatherhood.|
Fathom|to penetrate for understanding|Since I have always done my work, I cannot fathom why my boss just fired me.|
Fathomless|too great to be measured|The depths of the ocean seemed fathomless, reaching deeper than any man could measure.|
Fatigue|weariness brought on by exertion|During the fifteen-mile hike, one of the hikers collapsed from fatigue.|
Fatiguing|tiring; exhausting|We enjoyed the free cruise, but the mandatory seminar was fatiguing and took a lot of our time.|
Fatuity|pointless foolishness and stupidity|Even in his 40’s, the irresponsible man spent most of his salary on video games and other fatuity.|
Fatuous|lacking intelligence; stupid|Buying a car without negotiating down the price is a fatuous move.|
Faulty|defective and not functioning properly|Faulty wiring within the kitchen walls sent the house into flames.|
Fauna|wildlife of a specific area|The forest’s fauna are safeguarded by local wildlife life protection laws.|
Favor|preference for something more than its counterpart|Grandmother tended to favor boys over girls.|
Favorable|positive; showing approval|Favorable weather conditions brought both tourists and locals to the beach.|
Favoritism|showing partiality and preferential treatment|Showing favoritism between her children caused the mother’s oldest son to resent her.|
Fawn|to seek favor or approval by giving extra attention or praise|It was interesting to watch the greedy woman fawn over the wealthy old man.|
Fawning|giving attention in an overly flattering manner|Even the female reporters were smiling wildly and fawning over the handsome actor.|
Faze|unnerve; disturb|Negative comments aimed at the politician did not faze his nerves of steel.|
Fealty|an official acknowledgment of loyalty|When the president took his oath, he swore fealty to the nation.|
Fearful|experiencing a feeling of fear|Fearful of airplane rides, the terrified passenger braced herself for takeoff.|
Fearless|bold and unafraid|Fearless in the face of danger, Mala Yousafzai spoke up for the right of girls to be educated.|
Fearlessness|feeling no sense of fear|Priding themselves on fearlessness, neither of the brave warriors would retreat from battle.|
Fearmongering|the spreading of frightening rumors with the intention of causing fear or chaos|Fearmongering by the media caused the citizens to fear a nuclear war that wasn’t even looming.|
Fearsome|frightening or scary|Few creatures of the American forests are more fearsome than the Grizzly Bear, a hulking beast with massive teeth and claws.|
Feasible|to do without too much difficulty; possible|Driving with your eyes closed is not feasible.|
Feast|a large meal that is usually part of a celebration|Patrons brought in enormous platters food for a large feast in honor of St. Joseph.|
Feat|a deed of courage, endurance, skill, or cleverness|The man was honored when the king learned of his feat.|
Feather|a soft, thin outgrowth that covers the body of a bird|The bird’s soft feather detached from its wing and slowly floated down to the ground.|
Feature|a distinctive aspect of something|The most notable feature of his face was the piercing blue eyes that were as vivid as the sky itself and just as vast.|
Febrile|associated with a fever|The mother gave her febrile son acetaminophen to bring down his body temperature.|
Feckless|someone who is irresponsible or ineffective|Larry was such a feckless manager that the company was forced to declare bankruptcy.|
Fecund|intellectually productive or inventive|The computer programmer was a fecund person who could quickly identify and solve problems.|
Fed|supplied someone or something with food|As a volunteer, the days when she fed the homeless were most rewarding.|
Federal|relating to a state of government in which several states are united but are independent in internal affairs|The United States is an inherently federal government with many separate yet unified states working together.|
Federal|related to the central government|The federal court judge will rule on cases where crimes against the government were committed.|
Fight|to produce a positive outcome; defeat or achieve something|Jake arrived early at the community walk event to support the fight to stomp out homelessness.|
Figment|something that is believed to be real but only exists in imagination|My young daughter claims to have a unicorn as a best friend, but such a thing is clearly a figment of her imagination.|
Figurative|not accurate in meaning; as a form of speech|If you use figurative language, you are not speaking literally but rather in a manner meant to produce a reaction.|
Figuratively|not literally|Jim told the judge that when he spoke of chopping off Scott’s head, he meant it figuratively and not physically.|
Filch|to take illegally|The pickpocket was able to filch three wallets while on the subway.|
Filial|pertaining to a son or daughter|Frank has a filial affection for the uncle who raised him.|
Filibuster|a delaying tactic; a long speech given in order to delay progress or the making of a decision|The senator will filibuster to prevent a vote on the bill.|
Filigree|a delicate and intricate ornamentation made from twisted gold or silver wire|When the man went to purchase a gift for mother’s day, he chose a silver filigree necklace.|
Filler|a short article or ad in a newspaper or magazine|Reader’s Digest magazine uses unique jokes for a filler and will often pay their readers for the use of them.|
Filthy|extremely dirty|Because she never cleans her filthy home, the lazy housewife’s house is caked in dirt.|
Finagle|to acquire something by deception or scam|In order to finagle getting the candy from his father before dinner, the little boy explained to his dad that mom was serving dinner at a much later time.|
Finale|the grand end of something especially a show or piece of music |I was on the edge of my seat last night while watching the finale of my favorite television show.|
Finality|a final or unchangeable condition|I could not stop crying when I realized graduation was the finality of my high school life.|
Finance|to pay for something or provide monetary support for it|A politician that is truly interested in a particular cause will finance that cause with their own money.|
Financial|related to money matters|Because of financial problems, the struggling family can no longer waste money on things like going out to eat or to the movies.|
Finery|expensive objects or clothing|The evening dress designer’s finery is sold for several thousand dollars each in her high-end shop.|
Finesse|skillful handling of a situation|The chess champion played the game with a finesse that allowed him to easily beat all the other players.|
Fingerprint|the mark made on something from the tips of the fingers|After analyzing the fingerprint that was left at the crime scene, Detective Jones determined that it was left by the criminal when he put his naked hand on the table.|
Finicky|overly fussy and particular in regards to taste or standards|The finicky toddler refuses to eat anything other than chicken strips and French fries.|
Finish|complete something or task; a final end|On school days, Kathleen needs to finish her homework before playing outside.|
Finite|having limits|They had only a finite amount of gas, which is why they had to turn the generator off during the day.|
Firebrand|someone who is passionate about a social or political cause and tries to make people feel the same by stirring up emotions and instigating trouble|Because he was labeled a firebrand, the protester was not allowed to attend the rally.|
Firm|solid; refusing to bend|The firm steel-rod could not be broken except under intense pressure.|
Firmament|the body of the sky|According to many versions of religious scripture, God molded man from the firmament of the sky and placed him on Earth.|
Firsthand|obtained personally or directly (usually referring to information drawn from a source)|Survivors of the plane crash gave firsthand accounts to the news reporter once they were released from the hospital.|
Fiscal|associated with financial affairs|My daughter lacks a sense of fiscal duty and rarely pays her bills on time.|
Fission|splitting something into two or more parts|Nuclear fission is made by separating one atom or combining two different atoms.|
Fissure|a narrow opening or crack|The homeowners were dismayed to discover a fissure in the foundation of their home.|
Fisticuffs|a fight that involves using fists as weapons|While the two men were outside engaging in fisticuffs, the woman they were fighting over left the bar with another man.|
Fitful|unsteady; erratic |Jim was tired when he woke up after a fitful night of sleep.|
Fitness|a state of healthy physical condition|Fitness is an important part of your life, making sure your body stays healthy so you can live a longer and happier life.|
Fixture|an object or device permanently attached to the wall of a structure|Replacing the brass light fixture in the old house by installing a modern ceiling fan made the house look newer.|
Fizgig|a young woman who acts silly and flirty|The playful fizgig threw herself at any man at the bar who took notice of her.|
Fizzle|to finish something or die out slowly|Karen’s and John’s argument about money began to fizzle out when a bonus check just arrived in the mail.|
Fjord|a lengthy but thin body of water stretching through steep bluffs on either side|Sailing proved difficult for the expert boaters when they tried to cruise through the fjord without hitting the rocky sides.|
Flabbergasted|overwhelmed by amazement|As a single mother on a tight budget, I am flabbergasted by the huge cost of video games.|
Flaccid|short on force or strength|The flaccid wind did not stir the chimes on the front porch.|
Flagellate|to punish by severely whipping for a certain purpose|American citizens feared the courts would flagellate them for vandalizing cars in Singapore leaving strap marks on their backs.|
Flagellum|a long tail-like part of a cell that helps it move|Biologists analyzed the flagellum under a powerful microscope to determine if it provided assistance to a cell’s function.|
Flagging|becoming weaker, slower, or less effective|The man’s flagging business is now on the verge of closing its doors forever.|
Flagitious|to act in an evil way|Every student would avoid walking near the flagitious bully due to his abusive words and violent actions.|
Flagrant|noticeably bad|After the basketball player committed a flagrant foul, he was kicked out of the game.|
Flagship|the ship that carries the commander of a fleet|The commander boarded the flagship and prepared for its maiden voyage.|
Flagship|the best or most important thing produced by a company|The chain’s flagship store sells more hamburgers than any other location.|
Flail|to move uncontrollably in the air|When Pete’s daughter ran out into the middle of the street, he had to flail his arms to get the cars to stop.|
Flailing|to move uncontrollably in the air|Her flailing sign flapped in the heavy wind since it was only secured to the post with two staples.|
Flair|the natural capability to do something very well|Anna demonstrated her flair for drama by passing out when her daughter announced she was not going to college.|
Flak|adverse criticism|The unhappy customer gave George flak for the long wait time.|
Flamboyant|displaying flashy or loud behavior|The flamboyant singer loves to wear shimmering suits while performing.|
Flame|something that is compared to fire’s ability to burn fiercely or be extinguished|The flame of hope burns brightly in the hearts of the rebels even though their plight is dire and they face death every day.|
Flare|a sudden pop of fire|The flare from the lighter scared the small child as the flame illuminated her face.|
Flash|a sudden brief burst of bright light or a sudden glint from a reflective surface|The first flash of the fireworks caught her by surprise.|
Flashback|part of a story or life that reveals something that happened previously|We learned about the main character’s childhood through a long flashback.|
Flashy|showy and wanting to show off one’s wealth/skills in an obnoxious way|The rap mogul was flashy with his money and showed off his wealth through blinged-out jewelry and expensive cars.|
Flat|low and smooth with no curved parts|People once thought the world was flat, but now realize that it is round in shape.|
Flatline|to stop being popular or successful|After the actor was accused of several crimes, his success began to flatline, and he lost his fortune.|
Flatten|to make something completely flat or level|Joel requested the chef flatten his burger since he prefers thin meat over thick chunks of beef.|
Flattery|giving excessive and often fake compliments to receive a favor|The failing student tried to use flattery to persuade his teacher to up his grade, but no number of compliments were enough to convince her.|
Flatulence|state of having gas in the digestive system |I have a major problem with flatulence that is rather embarrassing especially when I’m in public.|
Flaunt|to show off (brag)|Eric loves to flaunt his flashy clothes because he thinks that he is super cool.|
Flaw|a fault or imperfection in a person or object|The diamond had no flaw and was perfect in every way.|
Fleck|a small patch of color or light|In the darkness of the night sky, each star is a fleck of light that makes the entire thing brighter and more than a sheet of black.|
Fledgling|an individual or group that is inexperienced or not fully matured|The fledgling writer could use the benefit of a good editor.|
Flee|to run away|Deciding to flee her war-stricken country, the refugee made a plan to leave quickly.|
Fleece|a soft, warm fabric with a texture similar to sheep's wool that is used as a lining material|The fuzzy fleece jacket kept the camper warm on the cold winter night.|
Fleet|a group of vehicles that are under the same command or with the same purpose and headed to the same place|The police fleet raced down the highway after a stolen vehicle.|
Fleeting|occurring for only a brief time|Now that my daughter’s fleeting interest in ballet has passed, I no longer have to be her chauffeur.|
Flexibility|the ability to bend or twist the body without injury|The ballerina’s flexibility allowed her to do lots of bends and turns.|
Flexible|easy to bend or change|If your vacation dates are flexible, you can get a much better deal than if you are rigid.|
Flexion|bending a limb|Ankle flexion before running can help strengthen the muscles and make the sprint for more manageable.|
Flexuous|having bends or curves|Driving down the flexuous road, the driver was made nervous by all of the sharp curves and abrupt bends.|
Flibbertigibbet|a flighty individual who talks a great deal about nothing|It was my misfortune to be stuck next to a chatty flibbertigibbet during the bus ride home.|
Flibbertigibbet|a person seen as a silly chatterbox that talks too much|Nicknamed Chatty Cathy, Catherine was a flibbertigibbet who blabbed to anyone she met.|
Flick|to move or hit something with a quick movement|As soon as he began to flick the spicy food with his tongue, the chef realized he had added entirely too much jalapeno.|
Flicker|a tiny, almost imperceptible movement|There was a flicker of light from the candle on the windowsill due to the small gust of wind that moved through the house.|
Flier|one that travels in the air|Each flier on the plane was required to listen to a speech on safety procedures.|
Flight|a group of people or creatures that fly through the air together|A charter flight carrying the opposing soccer team arrived at the airport earlier today.|
Flimsy|likely to bend or break under pressure; weak, shaky, flexible, or fragile|Don’t give me the flimsy excuse that you were too deep asleep to hear the phone ringing.|
Flinch|to cringe or jump slightly unintentionally|The young boy would flinch when the bee buzzed right next to his ear causing his head to turn suddenly away from the bee.|
Fling|to toss or throw something quickly|His attempt to fling the fishing line across the pond ended with a hook in the bushes.|
Flint|a solid rigid rock that is usually used in order to make a flame|A leader from the Boy Scouts Troop 997 quickly showed the boys how to use flint in starting a fire in the wilderness.|
Flinty|resembling the hardness of flint|The man continued to grind his feet against the flinty ground in an attempt to get the mud off of his shoes.|
Flip|to turnover or cause something to turnover suddenly|Waiting on her stylist, the woman began to flip through a book in search of the perfect cut.|
Flippancy|a manner that lacks respect or seriousness|The unserious worker’s flippancy caused him to be fired from his job.|
Flippant|lacking proper respect or seriousness|The student’s flippant actions towards the teacher got him suspended from school.|
Float|to stay atop of water in a resting or moving way|Once the sink was filled with water, the soap would float across from one side to the other.|
Floccinaucinihilipilification|approximating something as of having no value or rubbish|Since there was very little education derived from comics, teachers rarely used them as reading material due to this floccinaucinihilipilification.|
Flocculent|fluffy, wool-like appearance|The Pomeranian was so flocculent that is resembled a fluffy cotton ball.|
Flock|a group of one type of birds|The flock of seagulls flew over the ocean looking for any fish it could grab for food.|
Flog|to beat with a stick or whip|The king continued to flog the proud whipping boy, but even the mighty strikes of the whip could not bring him to tears.|
Flood|a larger amount of water than can fit into the container which causes it to spill over the sides|Once the large dam broke, the flood of water quickly gushed over the sides onto the land.|
Flop|to drop down in a hefty and wobbly way|After a long day at work, the girls flop down on the sofa and won’t move for an hour.|
Floppy|limp or loose|The rabbit’s floppy ears bounced around as it hopped through the tall grass.|
Flora|all of the plants located in a particular habitat|Flora in the eastern region includes over 7000 types of plants.|
Florid|to have a red or rosy complexion|The police officer was florid after being held up by a six-year old boy with a water pistol.|
Flotilla|a group of ships or boats|With the flotilla stocked with supplies, the ships set sail and headed towards the New World.|
Flotsam|objects or individuals that are considered to be of no worth|According to the old saying, one man’s flotsam is another man’s treasure.|
Flounce|to storm or stomp around in an agitated way|Feeling misunderstood, the girl decided to flounce off in a huff.|
Flounder|to act clumsily or confused|The new swimmer had to flounder in the deep end until the lifeguard dragged him to safety.|
Flourish|to develop well |The fertile ground and ample water supply will allow the crops to flourish.|
Flout|to intentionally disobey (a law, rule, convention)|People find themselves in trouble because they think they’re clever enough to flout the law without getting caught.|
Flower|the part of a plant that develops into a seed or fruit|Snails like to munch on plant parts such as orchid flower spikes and buds.|
Flown|travelled by air; a verb tense of fly|During the riots, we were flown out of the city by helicopter.|
Flu|shortened form of influenza-a highly contagious upper respiratory virus|Although there are vaccines to defend against the virus, flu strains vary and can’t fully be protected against.|
Flubdub|empty talk that is considered nonsense|The students got in trouble for their flubdub, especially since their talk wasn’t about school work.|
Fluctuate|to shift back and forth uncertainly|Each day, the price of gold will fluctuate on the market.|
Flue|part of the chimney that allows the smoke to exit|When the house smelled of stale smoke, the homeowner realized that the flue in the chimney needed cleaning.|
Fluent|able to express oneself easily|The taxi driver was fluent in several languages, allowing him to help the city’s immigrants move around.|
Fluffy|to be furry or soft|Karen’s fluffy cat would brush up against me with her soft fur, but it would leave cat hair on my pant’s leg.|
Fluid|to simply pour forth or stream|All of the bottles of juice are measured in fluid ounces since the volume is liquid.|
Fluidity|the ability for a substance to flow easily|There is fluidity between the two offices since both managers frequently move in and out of both spaces.|
Fluke|a coincidence or accident that something happened|Since I didn’t study or attend class on a regular basis, it was simply a fluke that I passed the exam.|
Flummery|kind words that were said without really meaning them|The teacher never took the teenager’s flummery as sincere since the teen usually said whatever words would get what she wanted.|
Flummox|to baffle or make confusing|The defense attorney’s questions were designed to flummox the prosecuting witness.|
Flummoxed|very confused|Since the therapist had never seen a delusional person before, she was quite flummoxed by Harry’s unusual behavior.|
Flurry|a light falling of snow or leaves|Even the kids knew that the small flurry of snow was not enough to get school called off.|
Flush|smooth, even, aligned; not sticking out|While making a bookcase it was important to keep the boards flush before securing the position using glue and clamps.|
Flustered|distressed and/or confused |The flustered defendant began to yell at the prosecutor.|
Flute|a musical instrument in the woodwind family that is played by holding it sideways and blowing air into a hole|The piercing sound of the toy flute echoed louder than the boy’s other instruments.|
Flutter|to wave wings back and forth quickly|The hummingbirds flutter their wings so quickly that a person can barely see the wings at all.|
Flux|continual change|My hotel reservations are in flux because I can’t decide where I want to stay during my vacation.|
Fly-by-night|unreliable or untrustworthy, particularly in business matters|There are many fly-by-night providers of goods on the internet, so buying products online only from reputable websites is probably a good idea.|
Foci|the centers or central parts of focus/activity|The foci of the paper were the many reasons why people came to the U.S. and the ways they immigrated.|
Focus|to pay attention to or study something closely|If students focus during class, they should easily be able to pass their tests.|
Fodder|a person or thing that is used for a specific reason|The celebrity’s arrest made great fodder for the tabloid journalists.|
Formative|able to affect an individual or thing|The teen years are a formative time in an individual’s life because this is when one’s identity is formed.|
Formerly|previously|Mrs. Jones was formerly known as Ms. Smith, only changing her name after marriage.|
Formidable|something that inspires fear|Growing tomato crops during a severe drought proved to be formidable for one farmer.|
Formulate|to create, produce, or prepare something carefully|It is difficult to formulate an effective plan under pressure.|
Forsake|to give up or abandon|In order to be a nun, you must forsake all things which might interfere with your ability to dedicate your life to Christ.|
Forsooth|the truth or indeed|Forsooth, how can you expect to pass a course when you never attend class?|
Forte|an area in which an individual excels|Although dancing was Ann’s forte, she never considered having a career in entertainment.|
Forthcoming|impending; occurring in the future|The author’s forthcoming novel will be released next month.|
Forthright|direct and honest |If you are not forthright when answering the detective’s questions, you might end up in jail.|
Forthwith|at this moment; now|Forthwith, I need to get my wife a present because her birthday is tomorrow.|
Fortify|to strengthen|Storm shutters a good way to fortify your windows and prevent hurricane damage.|
Fortissimo|a musical direction that means very loud|The piano at fortissimo was so loud that it seemed deafening to our ears.|
Fortitude|strength of mind that enables a person to face challenges with courage|Even though the soldiers knew the odds were not in their favor, they had the fortitude to continue fighting.|
Fortnight|a period of 14 days|They wanted to have a month to prepare, but their time was cut in half, leaving them only a fortnight.|
Fortress|a fort or castle|The tall fortress was surrounded by a swampy moat and drawbridge that led to the fort.|
Fortuitous|happening by accident or chance|Mark proved to be fortuitous by selecting all six winning lotto numbers.|
Fortunate|coming by good luck or favorable chance|Grace was fortunate that she arrived home before the oven caught fire.|
Fortunately|luckily|Fortunately, I swerved out of the lane before a car came barreling down the one way.|
Fortune|wealth or riches|The railroad tycoon was able to build a huge fortune by expanding tracks all across the west.|
Forum|a meeting or other place where people can discuss a problem or situation|As a member of the forum, Tessa got to speak up about the water issues plaguing the city.|
Foster|to encourage or promote something|The man hoped to foster a strong work ethic in his son.|
Froward|used to describe a person who are disobedient and difficult to deal with|The froward child refused to listen to her parents and was disobedient most of the time.|
Frugal|careful in spending money|Stop being so frugal and just buy me a real gold necklace!|
Fruitful|being productive in any sense; yielding benefits|The extra work in the office turned out to be fruitful after all when Tyler was promoted.|
Fruition|the fulfillment of a goal achieved |After many obstacles, our dream of owning a restaurant has finally come to fruition.|
Fruitless|not productive; unsuccessful|After a week of fruitless efforts, the rescuers gave up the search for the missing woman.|
Frustrate|to disappoint or upset|The toddler was unaware how he would frustrate the family cat every time he pulled its tail.|
Frustrated|irritated; upset|Frustrated after sitting on the phone for hours, the angry customer eventually hung up.|
Frustrating|able to cause feelings of upset or annoyance|The frustrating toddler cried and screamed until both of his parents were totally annoyed with him.|
Fuel|to supply or power something|When you realize that food is a fuel used to propel your body, you will begin to choose healthier chow.|
Frigid|emotionally cold; indifferent|My frigid aunt did not crack a smile when she saw my adorable newborn.|
Frilly|trimmed with lots of layers, especially ruffles or lace|Pulling the lace material out of her drawer, the seamstress prepared to make a frilly dress for her daughter’s first dance.|
Fringe|a decorative edge made of loose threads, tassels, or twists (as seen on curtains, rugs, piece of clothing, etc)|The fringe of her jeans got caught in the escalator.|
Frippery|something that is showy or gaudy to the point of appearing silly or unnecessary|Skipping out on the frippery, the engaged couple decided to spend their money on a new home instead of a showy wedding.|
Frisk|to pass your hands over someone’s body in search of drugs or other weapons|Stop and frisk policies allow police to approach pedestrians and search them without cause.|
Frisky|full of playful and lively energy|Our frisky little terrier is always running after something in the yard.|
Frisson|an intense emotion that comes on suddenly|I felt a frisson of excitement when I realized my husband was throwing me a surprise party.|
Fritter|unwisely waste of time and spend frivolously; procrastinate|While shopping at the mall, I tend to fritter my money on items I don’t really need.|
Frivolity|that which is not necessary or meaningful|The spoiled heiress is known for her frivolity and once purchased fifty identical dresses so no one could copy her look.|
Frivolous|of no real worth|My mother often spends her monthly pension on frivolous purchases she never uses.|
Frock|a female dress or gown|At my cousin’s wedding, the young flower girl wore a beautiful fluffy mint green frock.|
Frolic|to move about playfully and energetically|It’s fun to watch the playful goats frolic around the meadow in the afternoon.|
Frolicsome|playful and fun loving|The playful professor set a frolicsome tone for the entire class period.|
Frond|along, thin leaf belonging to a fern or palm tree|A wispy frond of dill was plucked from the plant and mixed into the dish.|
Frontier|an area that has not been fully explored|The science fiction program begins with a description of space as the final frontier.|
Frontman|a person acting as the public face of an organization; often when lacking actual authority, or representing a covert group|In addition to being the frontman for the organization internationally, he;s also being in charge of the entire business.|
Frost|the thin, white layer of ice that forms in the air when the temperature is below freezing|During the early morning hours, a light layer of frost covered the cool windows.|
Frostbite|injury caused by parts of the body being exposed to severe cold, usually toes, fingers, ears, or nose|Lost in the freezing woods, the shivering hiker was afraid that frostbite would start to overtake his body.|
Frosty|a cold and unfriendly attitude|Old man George is always frosty, treating everyone around him with disdain and a general crotchety attitude.|
Froth|worthless or pointless ideas or discussion|This conversation was filled with so much froth that even an hour later we discussed nothing important whatsoever.|
Froward|used to describe a person who are disobedient and difficult to deal with|The froward child refused to listen to her parents and was disobedient most of the time.|
Frugal|careful in spending money|Stop being so frugal and just buy me a real gold necklace!|
Fruitful|being productive in any sense; yielding benefits|The extra work in the office turned out to be fruitful after all when Tyler was promoted.|
Fruition|the fulfillment of a goal achieved |After many obstacles, our dream of owning a restaurant has finally come to fruition.|
Fruitless|not productive; unsuccessful|After a week of fruitless efforts, the rescuers gave up the search for the missing woman.|
Frustrate|to disappoint or upset|The toddler was unaware how he would frustrate the family cat every time he pulled its tail.|
Frustrated|irritated; upset|Frustrated after sitting on the phone for hours, the angry customer eventually hung up.|
Frustrating|able to cause feelings of upset or annoyance|The frustrating toddler cried and screamed until both of his parents were totally annoyed with him.|
Fuel|to supply or power something|When you realize that food is a fuel used to propel your body, you will begin to choose healthier chow.|
Fugacious|short-lived, fading quickly, tending to disappear|The preacher held forth about the fugacious nature of life, and how it ends so quickly.|
Fugitive|an individual who is fleeing incarceration or a threatening situation|The fugitive is being chased by a multi-state task force.|
Fugue|piece of music|Composing the fugue was easy for the singer once he had the melody down.|
Fulcrum|the thing or individual upon which everything depends|The factory is the fulcrum of our town because most of our citizens work there.|
Fulfill|to carry out|The salesman was dismissed because he did not fulfill the required quota.|
Fulfilment|satisfaction or happiness derived from the achievement of something important to oneself|Many people experience a sense of fulfillment when they finally achieve their life’s dream, or even when they take a step towards it.|
Fuliginous|sooty; smoky|Smog has caused many of the high-rises in the city to be fuliginous.|
Full-fledged|fully developed|My high school was putting on a full-fledged musical theater production.|
Full-scale|as complete or all-inclusive as possible|It will be hard to get a full-scale experience of the theme park if you’re only there for one day.|
Full|containing as much as something is capable of holding having no leftover space|The four year old wanted to get a refill for his drink, but since the cup was full there was no need to.|
Fulminate|to complain angrily or loudly|The disgruntled customer continued to fulminate over a price difference.|
Fulsome|extreme flattering to the point of excess|The stranger’s fulsome attention put me on edge.|
Fumble|to mishandle or let something slip accidentally from the hands|When the rookie football player entered the field, it would only be a matter of time before he would fumble the ball which was picked up by the opposing team.|
Fume|the build up of anger that generally results in a negative reaction|Molly started to fume and felt the urge to punch something when she found out her boyfriend was cheating on her.|
Fumigate|to cleanse or sterilize an area using a gas or vapor substance|An infestation of roaches caused a hired exterminator to demand everyone to leave the house since he would fumigate it with a hazy material.|
Fun|enjoying or entertaining|Going to the exciting party was the most fun I’ve had in ages.|
Functional|useful; practical |The expensive dress was out of the accountant’s budget, but she convinced herself it was functional and could be worn to other events.|
Functionary|a public servant who does specific tasks for his or her job|Training is mandatory for any functionary to complete the duties of his or her job.|
Fund|to supply money to someone or something for a certain reason|I needed to fund my checking account with enough money to cover the three checks I wrote today.|
Fundamental|basic or essential part|Dribbling is a fundamental part of basketball.|
Fundamentalism|a strict organization that follows their spiritual beliefs|Their fundamentalism required that the followers attend church daily or face severe consequences.|
Funeral|a ceremony held by family members to honor and bid farewell to the deceased|We have to hold a funeral for my Uncle, who died a few days ago, but I don’t have any black clothes to wear to it.|
Funereal|to feel sorrowful or mournful|After the death of a loved one, the funereal feelings during the funeral could be seen by the tears in everyone’s eyes.|
Fungi|a type of organism that is mostly known for including mushrooms|Analyzing the fungi in science class allowed the students to determine that the plants all produced spores and fed on natural material.|
Fungible|capable of being switched for something of equal value|On the diet plan, the two vegetables are fungible so you can eat either one without changing your calorie count.|
Funny|humorous; amusing|Live comedy shows are funny, but I prefer laughing at sitcoms from my couch.|
Fur|the outer coat of fuzz on an animal|My dog’s fur needed brushing because it was so matted down from him rolling in the mud.|
Furious|extremely angry|The prospective cadet was furious with himself for oversleeping and disqualifying himself from the academy.|
Furlough|a vacation or period of absence from work|To save money, the county will give teachers a two-day furlough this year.|
Furnace|a piece of equipment used to heat an area in a house or building|A broken furnace proved to be an annoyance for the family when there was no heat in the house until it was fixed.|
Furnish|to provide something to someone|The advertisement stated that the owners would furnish the apartment with tables, chairs, beds and a couch.|
Furniture|useable furnishings in a house or building|I enjoy refurbishing furniture by buying worn tables, chairs and desks and cleaning them up to become beautiful pieces.|
Furor|a situation that angers and upsets many people|Amid accusations of fraud, there was a public furor when the politician was arrested.|
Furore|great emotion (either positive or negative) shown by a crowd of people|Furore from the protestors outside could be heard from the president and the remaining workers inside the company.|
Furrow|a thin wrinkle or line on an individual’s face |If you observe my father while he’s in a thoughtful mood, you’ll see a furrow above his eyes.|
Furrowed|crumpled or to make wrinkles|The angry toddler furrowed his face which made it obvious to see that he was very upset at his mother.|
Furry|the state of having fur or the softness of fur|A bear cub is an extremely furry creature, likely soft to the touch, but you should avoid doing that if you don’t want to get mauled by its mother.|
Furtherance|a continuance usually by assisting something|The furtherance in the study of the document showed that it was a fake which was not noticed before by the researchers.|
Furthermore|additionally; besides|Texting while driving is dangerous, and furthermore, it is also illegal.|
Furtive|marked by quiet, caution, and secrecy|Crissy walked outside in a furtive manner so that her parents would not see her.|
Fury|intense anger or rage|With all of its fury, the volcano erupted over the mountainside and covered all life with its ferocity.|
Fuse|to combine into one thing|In the cooking contest, I will fuse Mexican and French recipes to make a dish I will refer to as Frexican.|
Fuselage|an aircraft’s center body section|The engines were positioned up under the aircraft’s fuselage as they need to be centered.|
Fusillade|a huge quantity of firings that occur rapidly|During the police interrogation, I felt as though the detectives attacked me with a fusillade of questions.|
Fusion|a joining or blending of two things into a single item|The actor worked so hard to become the character that it seemed the fusion of their personalities might be permanent.|
Fuss|to show excessive concern about something|My worrisome mother loves to fuss over my hair every time I wake up with wild locks.|
Fussy|hard to please|Refusing to be soothed, the fussy baby whined and cried all night long.|
Fustian|heavy cloth woven from cotton|Settlers used fustian to weave their clothes since it was a tough fabric that held up well.|
Fustigate|to criticize someone harshly|The abusive husband tends to fustigate his wife, beating her down emotionally with his cruel name-calling.|
Fusty|smelling stale, stuffy, or damp|The fusty cupboard smelled stale and damp after years of not being opened.|
Futile|incapable of producing any results|Although the dog chewed and chewed on his leash, his efforts to break free were futile.|
Future|a period of time that is yet to come|Our future vacation is planned for May of next year.|
Futuristic|something having to do with the future|A futuristic model car was on display in the museum, representing what transportation might look like in 50 years.|
Futurity|the future|Anxious thoughts of futurity caused the worrier to lose hope in the present.|
Futz|to waste time or idly deal with a task|The student knew that she should focus on her studies but decided to futz around for most of the afternoon.|
Fuzz|a short, frizzy mass of fiber or hair|The towel fuzz rubbed off onto my usually silky clothing while in the wash.|
Gabble|rapid and generally unintelligible speech|The man’s hastily spoken words came out as little more than a gabble to the ears of both me and my spouse.|
Gadfly|an annoying person who is a nuisance by constantly criticizing others|The television commentator is a gadfly whose main purpose on the show is to criticize others.|
Gadget|useful mechanical object or tool|Every time I shop for a birthday present for a family member, I tend to buy a new unique kitchen gadget for myself.|
Gaffe|an obvious error or mistake|Because of the quarterback’s gaffe, our team lost the big game.|
Gag|an obstructive object put over or in a person’s mouth to stop them from making noise|A strip of cloth is often used as a gag to keep restrained prisoners from making any noise or calling for help.|
Gaggle|a disorderly and noisy group of people|The gaggle of middle school students exited the school with excited chatter and yelling, a sure sign of their joy for the end of the school day.|
Gaiety|celebration; partying|The gaiety is in honor of the principal’s retirement.|
Gain|to use one’s efforts to get or secure something|By helping out in his dad’s donut shop, Josh was able to gain work experience while still in school.|
Gainful|profitable; able to make money|Allen has a part-time job, but is actively looking for more gainful employment.|
Gainsay|to contradict or deny|Since Jack told the truth on the witness stand, no one was able to gainsay his statement.|
Gait|manner of walking|As he strode through the hallway, everyone could tell by his gait that he was wealthy.|
Galactic|relating to a system of millions or billions of stars in the solar system|Our galaxy is the Milky Way and our closest galactic neighbor is the star system Andromeda.|
Galaxy|a group of many stars, along with gas, dust, and dark matter|Our galaxy, the Milky Way, is made up of the sun, planets, asteroids, millions of stars, and other space junk.|
Gale|a very strong wind|My favorite hat was blown off my head by the gale as I ran from into the house from my car.|
Gall|daring conduct|After Paul made the mistake, he had the gall to blame me for his error.|
Gallant|fearless and daring|Despite being outnumbered the gallant soldiers were eager for battle.|
Gallery|a room or a building used for showing works of art for sale|There is no lack of people who attracted to what may be considered unusual art shown in a gallery.|
Gallimaufry|a confused mess of things|The excuses of the young children was a gallimaufry of nonsense, each of them saying something different that made no sense.|
Galling|triggering annoyance or anger|The fraud allegation was galling and really upset the honest minister.|
Gallivanting|to roam from place to place for pleasure or excitement|The mischievous wanderer was gallivanting around town in search of something to entertain himself, paying no heed to those around him.|
Gallon|a fluid measurement that equates to sixteen pints|The mother knew she would need to buy a gallon of milk in order for her family of four to have enough milk for the week.|
Gallop|when a horse runs at full speed|The startled horse broke into a swift gallop and darted through the trees.|
Gallows|a construction frame on which people are hanged for their crimes |The gallows is a structure that was once used to put people to death by hanging.|
