Laborious|something requiring much physical or mental effort|When you just start exercising it may seem laborious, but over time it gets easier.|
Labyrinth|a complicated irregular network of passages or paths in which it is difficult to find one's way; a maze.|At the farm, I found it very easy to get lost in the labyrinth of corn stalks.|
Laceration|an irregular open wound caused by a blunt impact to soft tissue|Because the laceration was so deep and ugly, Dick was rushed to the emergency room by an ambulance.|
Lachrymose|easily brought to tears|After her husband died, my aunt became a lachrymose woman who couldn’t stop crying.|
Lackadaisical|feeling or showing a lack of interest or enthusiasm|After the surgery, I was lackadaisical for several days.|
Lackey|a servant that does menial tasks|The wealthy gent’s lackey toted his luggage all over the resort.|
Lackluster|lacking brilliance and shine; dull; not exceptional; not worthy of special merit, attention, or interest|Since she noticed that the response she was getting on the dating website was rather lackluster, Beth decided to spice up her profile and post a better photo.|
Laconic|brief and concise, using few words|During the laconic phone call, the divorcing spouses only said what was absolutely necessary.|
Lacquer|a clear or colored coating that is painted on wood or metal|Lacquer was added to the dresser’s surface to give it extra shine.|
Lacuna|a gap or missing part|The story’s plot was missing, creating a lacuna in the middle of the text.|
Lad|a young boy|Police questioned the lad for an hour, but were not able to pinpoint him as a suspect.|
Laden|weighed down by a large amount|The party table is laden with assorted snacks and beverages.|
Laggard|an individual or group that falls behind others|In the race, James was the laggard who finished in last place.|
Lagniappe|a small gift given to a customer when purchasing something|As a lagniappe, the department store offered free popcorn and drinks to all its customers.|
Laid-back|relaxed and easy-going|Angie wished to give up her busy, New York City lifestyle for laid-back beach life.|
Lair|a place inhabited by a wild animal, often a cave or a hole in the ground|After stalking a sheep and ripping it to pieces, the tiger dragged its fresh kill to its lair.|
Laissez-faire|The policy of not interfering in the affairs of others |Since the dictator is killing Christians in his country, there is no way Christian nations can simply do nothing while observing a laissez-faire policy.|
Laity|members of the church but who are not ordained ministers or priests|Holding confession, the priest had the laity line up one by one to confess their sins.|
Lambaste|to criticize someone harshly|Even with its success, harsh party leaders continued to lambaste the plan for healthcare reform.|
Lambent|refers to the glowing and flickering of a fire|A lambent glow flickered from the low burning campfire.|
Lame|having disabled legs or feet|Lame in his feet, the once energetic man was no longer able to move around.|
Lament|to express sorrow or regret; to mourn aloud|I lament by crying my eyes out.|
Lamentable|worthy of criticism or regret|Few events are as lamentable as an attack on innocent people by terrorists.|
Lampoon|nan|Because Freddy posted an uncomplimentary lampoon of his boss on his Facebook page, he soon found himself looking for new employment.|
Lance|a long, thin pole with a sharp point carried by horsemen|Every tribesman carries around a lance whose tip is so sharp that it pierces the flesh at the slightest touch.|
Landfill|a place where waste is buried underground|All trash placed in the city’s dumpster was buried deep in the landfill.|
Landform|a mass made up of materials typically considered land, such as dirt, stone, sand, etc|Sailors that are out at sea often look for some sort of landform to signal the end of their journey, though they may pass some islands that aren’t their final destination.|
Landlocked|completely surrounded by land|Many landlocked countries in Africa lack the natural resources needed to sustain a stable economy.|
Landlord|a person who leases their property to another person or company|Beating on her delinquent tenant’s door, the landlord threatened to file a lawsuit if rent wasn’t paid.|
Landmark|a well-known object in a particular place that helps a person know where they are|It wasn’t an X, but the small stone that served as a landmark for the location of the buried treasure.|
Landscape|to decorate with plants|To add extra character, the painter always makes sure to landscape his scenes with at least some greenery.|
Landslide|a win that was gained by a large margin|After losing the election in a landslide victory, the candidate called his opponent to concede defeat.|
Languid|very slow and relaxed|I always get my rest when I take a languid cruise vacation.|
Languish|to be or become weak or dull; lose strength or vigor; fail to make progress or be successful|If Congress allows the budget bill to languish on the shelf, then the country will find itself in a financial crisis.|
Languishing|losing strength; becoming feeble and weak|After many weeks lost at sea, the languishing men were quickly losing all strength.|
Languor|weariness or exhaustion|If you do not drink enough water, you will become dehydrated and fall into a state of languor.|
Languorous|lazy and lethargic|The languorous teenager would rather lay in bed playing video games than actually do something constructive.|
Languorous|lacking in energy and enthusiasm|After working all week, the exhausted woman wanted to enjoy a languorous day in bed.|
Lanky|awkwardly tall and skinny|Long-limbed and lanky, it was hard for the man to fit inside the compact car.|
Lantern|a lamp with a protective case around the flame|A brown rustic lantern hung from the porch and lit the way for weary travelers.|
Lapse|A temporary failure; a slip|His lapse in judgement led him to fall behind in his studies.|
Larceny|unlawful taking of personal property|After finding his computer was not where he left it, he accused his sister of larceny.|
Large|of greater size than normal|Large birds with great wings flew high over the river valley.|
Largesse|generous acts of giving gifts or money to a large number of people|Because of the millionaire’s largesse, twenty underprivileged graduates now have college scholarships.|
Laryngoscope|a medical instrument specifically used to examine the human larynx|Because my voice was hoarse, the doctor had to use a laryngoscope to see if there was anything wrong with my larynx.|
Larynx|an organ in the neck of humans and animals that contains your vocal cords; voice box|Strain on her larynx caused the singer’s voice to crack.|
Lascivious|having or showing strong sexual desire|After running naked through the field, he was arrested for lewd and lascivious behavior.|
Lassitude|tiredness and a lack of energy|After the long race, Jack experienced a feeling of lassitude.|
Latch|to fasten a door or gate with a latch or a lock|We had to latch the door closed with a lock so it would not fly open when it got windy, since the last storm made a mess.|
Latency|the period of time that one component in a system is waiting for another component|A system update allowed the system to run faster and reduced any latency or wait time.|
Latent|existing or present but concealed or inactive|The detective asked the lab technician to search the room for latent fingerprints.|
Lateral|of or pertaining to the side|A beam runs along the top of the bridge, offering lateral support to the structure.|
Latitude|having the choice to do something |My father gave me the latitude to choose my own curfew on prom night.|
Latter|used to signify the second part of something|My favorite fruits are apples and watermelon, especially the latter on a hot summer day.|
Lattice|crisscross or diamond pattern with spaces in-between|I pierced through the wooden lattice, splitting the diamond pattern in two.|
Laud|to praise or glorify|The company decided to laud Jack’s outstanding contributions to the firm.|
Laudable|deserving to be praised or admired|While Jason did not win the contest, his efforts were laudable enough to be mentioned by the judges.|
Laudatory|giving praise|The laudatory announcement praised the team’s efforts during the championship game.|
Laugh|to make the sounds and movements of the face and body that express happiness|The children began to laugh and giggle as the clown performed goofy tricks for them.|
Launch|to start or set something into motion|The space center prepared to launch the rocket far into outer space.|
Lavation|a washing or cleansing|She said she expected a thorough kitchen lavation when all she needed to say was that she expected a thorough kitchen cleaning.|
Lavish|luxurious or elegant|Every room in the five-star hotel was filled with lavish furnishings.|
Lawless|without law and order|The lawless Wild West was full of bandits and outlaws that didn’t fear the law because there weren’t many people to enforce them.|
Lax|relaxed and not strict|The lax entry requirements let just about anyone in.|
Laxity|the state of being relaxed, easy-going, or not very strict|The prevalent laxity toward marriage causes the divorce rate to rise.|
Liaise|to work together to create a desired outcome|To quickly settle the terms of the divorce, the husband and wife must liaise in an amiable manner.|
Liaison|a person who helps organizations or groups to work together and provide information to each other|As the liaison between the police department and the public schools in our city, my aunt coordinates officer visits to each of the schools.|
Libel|nan|I told Troy that I would sue him for libel if he posted that embarrassing picture of us on his Facebook page.|
Liberal|1) willing to consider new things and ideas2) quite generous|The political candidate’s liberal plans have enraged his conservative foes.|
Liberality|possessing the characteristics of someone who is generous and gives freely|J.K. Rowling shows great liberality to the poor and often donates several thousands of dollars to the charities each year.|
Liberate|to free|Because the dogs were experiencing maltreatment, the compassionate man decided to liberate his neighbor’s animals.|
Liberation|the act of setting someone or something free|Liberation of the country only came after the people were brave enough to fight for freedom.|
Libertine|someone who ignores moral values|My Uncle Charles is a libertine who lives with his four girlfriends.|
Liberty|the freedom to do and act as one pleases|Fighting for their liberty, the men could not wait to be free from the King of England.|
Libidinous|reflecting desires of a lustful nature|The libidinous man was constantly thinking of sex.|
Libretto|the words or lyrics of an opera or musical play|After many months of work, the libretto was finally completed and would be performed soon.|
License|a permit that allows for someone to do something such as run a business or drive|The boy has to take a written and practical test to earn his driver’s license.|
Licentious|lacking moral discipline or ignoring legal restraint, especially in sexual conduct|It is assumed that pagan festivals once involved many licentious activities, including a number of sexual games.|
Lichen|leafy or mossy like fungi that grows on rocks, trees, and other natural elements and retains water|Slimy green lichen grew on the rocks next to the creek.|
Licit|lawful; not forbidden|Although he did not agree with her choices, she was over 21 and he could not stop her licit drinking.|
Lie|to recline or stretch out|Every time I lie out on my beach towel for a long time, I end up with a sunburn.|
Liege|an individual who is loyal to a person of rank, usually related to the Medieval time period |The liege was willing to give his life for his king.|
Lien|a claim to the possession of another until a debt is settled|The bank has a lien on the truck until the buyer fulfills his financial obligations.|
Lieu|instead of something|The company issues additional shares to shareholders in lieu of a cash dividend.|
Lieutenant|an officer or deputy that acts as a substitute for a supervisor|The police leiutenant was responsible for running the entire jail in his boss’s absence.|
Life|the state between birth and death in which one is functioning|The police tried to convince the man on the ledge that his life was worth living.|
Lifeless|dead or appearing to be dead because of lack of motion|Paramedics got to the child’s lifeless body just in time to restart his breathing.|
Lifetime|the duration of the life of someone or something|While reading my cousin’s obituary it mentioned she gave a lifetime of service to the nursing profession and her community.|
Ligature|something used to tie or stitch something tightly|Serving as a ligature, the nurse wound the cloth around the man’s wound.|
Light-colored|light in shade or color|Wear a white or light-colored t-shirt to the beach so that you don’t get hot.|
Light-hearted|cheerful; happy-go-lucky|Laura went to go see a light-hearted film to put her in a better mood.|
Light|brightness from a natural means, the sun or a lamp that allows you to see something|In case I arrive home after dark, I have my front room light set with a timer to turn on in the early evening so my dogs can see where they’re going.|
Ligneous|woody; looking like wood.|The ligneous chest of drawers looked like it was made of solid wood but was really particle board.|
Like|similar to something else|My new dog looks so much like my last puppy that it seems they could be friends.|
Likelihood|possibility or good chance of something happening or being|When the wind began to blow harder and the sky darkened, the likelihood of a storm approaching was relatively great.|
Liken|to point out similarities or a resemblance to something else|The disappointed travelers liken the horrible trip to going to a beach with no water.|
Likewise|in a related way|In time, the nightmares will go away, and likewise, I will no longer remember the accident.|
Lilliputian|a very small person or thing|Barely four and a half feet tall, the Lilliputian woman was the smallest one in her family.|
Lilt|a spirited song or tune|The small songstress sang an Irish lilt that raised the spirits of all the patrons in the bar.|
Limb|an arm or leg of a person or animal|The boy jumped off of the playground swing and broke his limb when he fell on his elbow.|
Limb|a large branch on a tree|A limb from a diseased oak tree fell on my car overnight.|
Limber|flexible; agile|The limber gymnast was able to do the backflip with ease.|
Limbo|being in a lost or unknown position|That has created a limbo in terms of how the military deals with gender-specific policies.|
Limerence|the overwhelming need to be with or receive similar feelings from another person that manifests in physical trembling and pain when the other person is not around. Beyond simple infatuation or lust|When Romeo first laid eyes on Juliet, he was struck with such limerence that his need for her became like a drug that could only be satisfied by returned feelings.|
Limitation|a restriction or restraint that is used to control|A limitation was placed on copies and now the workers can only copy a few papers a week.|
Limn|to represent in painting or words|The painter is known to limn pictures of his lovers on oil canvases.|
Limp|lacking stiffness or firmness, as of substance, fiber, structure, or bodily frame|Having forgotten to water it in weeks, the stalk of the plant was not limp and brittle.|
Limpid|see-through; clear |Because the sky was not limpid, we could not see the stars.|
Line|a row of persons or things|The teachers will often have to settle the children down while they’re waiting in the lunch line.|
Lineage|direct descent from a particular ancestor|Our family was ecstatic to learn about our royal lineage and how we descend from kings and queens of antiquity.|
Lineal|being in direct line of an ancestor|Mary learned that her lineal family tree leads directly back to English royalty.|
Lineament|an outline, or feature, or contour of a body or figure, especially the parts of the face |The young child traced the lineament of the statue.|
Linear|arranged or along a straight line|A linear path was created straight from the field’s first base to the second one.|
Lingo|language peculiar to a particular group or region|The rookie nurse was unsure how to respond to the doctor since she was unfamiliar with the medical lingo he was using in his question.|
Linguistic|related to languages|The linguistic instructor is here to teach us German, which is a difficult language to learn since it is different from Latin, which is the basis of more common languages like Spanish.|
Liniment|a topical solution used to alleviate stiffness or pain|Because of arthritic pain, I usually apply liniment to my legs every night.|
Link|a connection between places, people, events, or ideas|He has been a beat officer for the past three years and is a vital link between the community and police.|
Lionize|to treat (a person) as if they were important, or a celebrity|I hate when people lionize dead celebrities that were vilified during their lifetimes.|
Lipid|a substance (such as wax, fat, or oil) that will dissolve in alcohol but not water|Lipids are the building blocks of living cells and come in a variety of options (waxes, fats, or oils.)|
Liquefy|to turn something into a liquid|Using a food processer, the chef was able to liquefy the ingredients into a watery mixture.|
Liquid|a phase of matter that flows and takes the shape of the container it fills|Liquid spilled out of the top of the cup after the toddler dropped it.|
Lisp|when a person cannot pronounce “z” or “s” sounds properly|Christian's classmates made fun of his lisp, but he could not help that he could not make “s” and “z” sounds.|
Lissome|bending and moving about without any difficulty|The lissome figure skater moved effortlessly on the ice.|
Listicle|an article or piece of writing consisting of a series of items presented as a list|The website puts out a new listicle every day listing which celebrities have been arrested or done stupid things.|
Listless|without spirit or energy|The illness made me so listless I rarely got out of bed.|
Lit|exciting; fun|Last night’s party was so lit that I’m still reliving the fun in my mind.|
Litany|a lengthy record |The landlord was tired of listening to his tenant’s litany of complaints about the property.|
Literally|in an exact manner|After falling in the lake, I was literally smelling like a fish.|
Literate|able to read and write|The young toddler is literate, able to fully read and write at a very young age.|
Literature|written works (such as poems, plays, and novels) that are considered to be very good and have lasting value|Filled with literature, the library contained award-winning books from every genre.|
Lithe|gracefully flexible, and often accompanied by being thin and long|While Corinne has the lithe, agile body that would be perfect for gymnastics, she is too tall to manage some of the events.|
Lithological|related to the study of rocks|The geologist accepted a lithological position that put him in charge of screening the rocks found at the dig site.|
Lithosphere|the solid part of the earth that includes the crust|The geologists compared the solid crust of the lithosphere to other parts of the planet.|
Litigant|someone engaged in a lawsuit|A plaintiff is a litigant as is the defendant because they both are involved in a lawsuit.|
Litigate|to participate in legal actions|After not reaching an agreement, the two parties decided to go to court to litigate the settlement.|
Litigation|the conduct of a lawsuit|Charles entered into litigation when he opened a civil suit, attempting to hold his former employer liable for withholding wages.|
Litigious|relating to litigation; inclined to engage in lawsuits|Tom is a notoriously litigious individual who will sue anyone for anything.|
Litotes|is a literary term for a figure of speech that uses negative terms to express a positive statement|The Japanese woman used litotes to phrase her true thoughts in a nice way.|
Litter|trash that is lying in an open place|Loads of litter filled the polluted ocean, with the toxic trash making the fish sick.|
Littoral|relating to a shore or coastal region.|The littoral states of the Atlantic Ocean include South Carolina as well as New Jersey.|
Liturgy|preset practices that are carried out during a religious service or event|The priest has performed the baptismal liturgy over five hundred times.|
Livelihood|the way in which an individual earns a living|The singer’s livelihood depends upon his fans purchasing his music.|
Liveliness|being energetic, active, and outgoing|Playing and laughing, the children’s liveliness filled the whole room.|
Lively|active; full of energy|The lively children came barreling down the hallway.|
Livery|a special color scheme used as a design for vehicles|The livery of my favorite racer’s car is a full yellow paintjob that has two black racing stripes going down the middle.|
Livid|furious|Boris was livid with fury when he learned his wife’s killer was being released from prison.|
Living|alive; Not dead|Several different types of living creatures make their homes in the pond next door.|
Loathe|to hate very much|I loathe having to sit in the waiting room for hours.|
Loathsome|extremely offensive|Everyone avoided Jason because of his loathsome personality.|
Lobby|the main entryway located inside a building|Hotel guests must enter through the main entrance and check-in inside the lobby.|
Lobby|an entrance hall to a company, hotel or theater|Denise called me and said, “When you enter the lobby, sign in as a visitor with the receptionist before taking the elevators to the second floor for your training session.”|
Lobbyist|an individual hired to convince a legislator to act in a specific manner|As a lobbyist for a gun manufacturer, Harry tries to persuade legislators to vote against strict gun control bills.|
Locality|the position or geographic site something is in|The locality of North America is in the western hemisphere of the globe, more specifically in the upper quadrant.|
Locate|designate the site or place of|A New York business wants to expand and locate another factory in a city which has tax breaks and incentives reducing their startup cost.|
Lockdown|a situation in which people are not allowed to enter or leave a building or area freely|The prison inmates were placed on lockdown and weren’t allowed to leave their cells.|
Locomotion|the action or force of traveling from location to location|Traveling by airplane is the fastest means of locomotion.|
Locution|a word or phrase commonly used in particular situations|Although “LOL” is internet slang for “laughing out loud”, it has become an actual locution among the teenage girls in our school.|
Lodge|to firmly fix something in a place|Because the girl didn’t chew her food well enough, a piece of apple was able to lodge in her throat.|
Lodger|a person who lives in a rented space of another person’s home|Each lodger is responsible for paying his own rent and making sure his portion of the apartment is kept clean.|
Lofty|great and worthy of praise|The football players have set a lofty goal in their bid to win all their home games this year.|
Logic|rational thinking not based on emotions|Logic told the owner not buy the expensive car, but he went against his good judgement.|
Logical|rational, or expected of an intelligent thought process|If a stove is hot, the brain chooses the logical option and tells you not to touch it because it will hurt.|
Logistics|the process of managing the flow of information, goods, and/or services to customers or clients|It takes weeks to plan the logistics necessary for organizing a graduation ceremony for fifteen hundred students.|
Logomachy|dispute over the meaning of words|Not being able to decide on the correct definition for the word ‘inevitable’, the two engaged in a classic logomachy.|
Logophile|a lover of words|Shakespeare was such a logophile that he took the words he already loved and crafted them into new ones.|
Logorrhea|excessive wordiness with minor or sometimes incoherent talkativeness|Unlike our previous teacher whose logorrhea filled her lectures, this year’s teacher speaks so much more sparingly.|
Lollapalooza|a person or thing that is exceptionally striking or impressive|The exceptional music performance was a lollapalooza that stood out amongst all of the other acts.|
Loneliness|an emotion or feeling of solitude, in which one laments a lack of company|His day is marked by loneliness, without the company of any friends or family to make him smile or laugh.|
Lonesome|lonely because of lack of companionship|The monk claimed to never feel lonesome and swore he enjoyed living in solitude.|
Long-winded|lengthy and word in speech|The student’s long-winded response was much more lengthy than the client required.|
Long|measuring a great distance in length|The snake was very long, and its body stretched all the way across the sidewalk.|
Longevity|the duration of time that something or someone persists|The politician’s longevity in office will be determined by voter popularity.|
Longing|desperately wanting something|Longing for a cheeseburger, the craving wouldn’t subside until I made a midnight trip to McDonalds.|
Longitude|angular distance measured west or east of the prime meridian|The vertical lines that are found on the map are known as the longitude, while the lateral lines are referred to as the latitude.|
Longitudinal|running lengthwise|The longitudinal placement of the rug spread from east to west.|
Loom|to impend; to threaten or hang over|When the storm begins to loom over the horizon, we will head back to the car.|
Loophole|a mistake or vagueness in a regulation or law that allow all or part of it to be avoided or changed|Since the contract did not include the deadline for the work to be completed, the handyman found a loophole in the contract so he couldn’t be taken to court.|
Loopy|idiotic, crazy or drunk|Sleep deprivation will have you feeling loopy.|
Loose|not firmly or tightly in place|My pants were a bit loose around my waist, so I needed to find a belt to hold them up before I left the house.|
Loot|stolen goods or money|While raiding the village, the soldiers helped themselves to any loot that they could find.|
Lop|to cut something off|The landscaper used a hedge trimmer to lop down the grass several inches.|
Lope|to take a longer footstep while running or walking|Sprinters usually will lope in their lanes in order to ensure victory at the finish line of the race.|
Lopsided|uneven or unbalanced|Not realizing the table was lopsided, the patron placed his drink on it and water went everywhere!|
Loquacious|a person that talks a lot; talkative|After drinking four beers, my normally quiet wife becomes quite loquacious.|
Loquacity|the act of talking a lot|All I had to do was listen for the loquacity of a person on their cell phone to know that it was a teenager.|
Lord|a ruler who has power or authority over others|The lord was in charge of ruling everyone in his district and used his power to his advantage.|
Lore|information and wisdom gained through tradition|Lore was passed around the campfire in the form of old folktales.|
Lorn|feeling isolated and desolate|Once all her children left for college, the divorced mother felt lorn living in a big empty house.|
Lorry|a large open vehicle used for hauling supplies or soldiers|After the major battle, a lorry filled with medical equipment traveled to the army hospital to restock its inventory.|
Lose|no longer have someone|It is far more tragic for parents to lose a child from a sudden death as it leaves them with many unsaid things and feelings of regret.|
Lose|to misplace or get rid of something|I need a bright colored key chain since I lose my car keys at least once a week.|
Loss|failure to win|The basketball team was discouraged by their loss and vowed to practice more often before the next game.|
Lost|in an unknown location; unable to be found|When Karen lost her dog, she searched the area, called the shelter and placed flyers everywhere to improve the chances her pet would be returned.|
Lothario|one who lures women by pretending to fall in love with them|Lyle knew that his past reputation as a lothario would make it hard for him to prove his feelings to his girlfriend.|
Louche|dishonest and crooked|Suspicious of his ways, Kevin’s father never felt like he could trust his louche son due to his sordid past.|
Loud|a deafening sound|The music from the car passing by my house was so loud it woke up my infant child from her nap.|
Lounge|relax|After complete exhaustion, Henry decided to lounge on the sofa for a few hours.|
Louse|an immobile insect that extracts blood from humans or animals|Once the child began to scratch her head, a louse was found attached to a follicle of her hair.|
Lousy|something that is so terrible it’s shocking|The pizza was so incredibly lousy that she wouldn’t even give it to her worst enemy.|
Lout|an uncooperative and impolite male|When the neighbors witnessed his cruelty to animals, they informed the police of the actions of the lout.|
Love|to like or enjoy|The Dean children love to bake and enjoy serving treats to family and friends.|
Love|a deep feeling of fondness or affection|The love Ben felt for his wife showed in the way her cared for her while she was sick.|
Loveable|adorable; attractive|The lovable puppy looked up at his owner with his cute button eyes.|
Loveliness|the characteristic of being lovely or otherwise desirable|The sunset at dusk is truly lovely, a spectacle that no one should miss out on if they want to appreciate the beauty of nature.|
Lovely|beautiful; charming |Miranda’s lovely emerald dress looked beautiful against her fair skin.|
Low|small in height|In the newspaper, I read about another accident when a trailer truck tried to squeeze under a low clearance bridge.|
Lowdown|cruel and mean|Leroy was a lowdown, dirty rascal who loved to trick elderly women into giving him all of their cash.|
Lowlife|a criminal or other person with no morals or character|The lowlife squatter lives in other people’s vacant homes and destroys them when he leaves.|
Loyal|trusted and dependable|A man’s most loyal companion is his dog because it will always welcome its owner back when the owner takes a vacation.|
Loyalist|someone who supports their ruler or government, especially during a revolution|John is a tea party loyalist who is very outspoken about the evils of the Democratic party in the United States.|
Loyalty|the quality of being faithful and devoted, never wavering from allegiance|Craving loyalty from everyone in his kingdom, the paranoid king would kill anyone he suspected to be an enemy spy.|
Lubricant|oil applied to something to reduce friction|Applying excessive amounts of lubricant to the floor caused many customers to slip.|
Lubricate|to apply oil to a surface in order to reduce friction|Finding a product to lubricate the door was the only way to stop the annoying squeaking.|
Lubricious|having an oily and smooth quality|The other sun-bathers admired the woman’s gleaming and lubricious skin.|
Lucent|Emitting light; shining|Because it was overcast, I could not see the lucent moon in the sky.|
Lucid|easy to understand or thinking clearly|Because the medicine made Lisa drowsy, she was not very lucid.|
Lucidity|the capability to view things in a logical way|The colonel’s lucidity allowed him to quickly plan a strategy of attack.|
Luck|a force that allows good things to happen to you by chance and not as a result of one’s own effort|The lottery winner gained his fortune strictly by luck since he didn’t even pick his ticket numbers.|
Lucky|being fortunate or bringing fortune to others by chance|The basketball player was convinced that his lucky socks were the reason his team won every game they played.|
Lucrative|producing wealth; profitable|The wealthy businessman was constantly on the lookout for lucrative ventures that would help him become even wealthier.|
Lucre|money or profit gained illegally or immorally|Hiding the lucre in many different accounts, the mobsters kept a watchful eye on their funds.|
Lucubration|the process of applying oil or a similar substance to make something run more smoothly|The farmer applied oil to the tractor gears and explained that proper lubrication is required to keep his machine running.|
Ludicrous|something viewed as humorous because of its ridiculousness|The ludicrous movie is about a dog that becomes the president of a country.|
Luggage|suitcases or other bags that are used to pack personal items for travel, especially clothing|While packing their luggage for vacation, the couple made sure to include several swimsuits and sunblock.|
Lugubrious|looking or sounding sad and gloomy|In his first novel, the mysterious postman is the perfect example of a lugubrious character.|
Lukewarm|moderately warm; tepid|Disappointed by his lukewarm chicken wings, the diner requested hot ones from the kitchen.|
Lull|to put to sleep, soothe, or quiet|Soft and cool, the breeze succeeded in its task to lull the man to sleep.|
Lumber|raw cut timber beams|Environmentalists protested the lumberjacks’ actions because they were chopping down all the trees for their lumber.|
Luminary|a person who influences or motivates other people|Because Dr. Swanson is a luminary in the medical profession, he recently had a surgical procedure named after him.|
Luminous|producing or seeming to produce light |The movie editor used the computer program to give the actress the luminous appearance of an angel.|
Lummox|someone who is clumsy or regarded as unintelligent|I consider my baby brother a lummox, since he is constantly tripping over nothing and knocking things over.|
Lump|a swelling under the skin, often caused by infection or disease|A lump on the patient’s neck meant that his cancer may have returned.|
Lunacy|insanity; stupid or foolish behavior|People on several lower class talk shows exhibit behavior similar to lunacy when they yell, cuss, and fight each other over silly problems.|
Lunar|pertaining to the moon|Our class was studying the lunar landing of 1969.|
Lunatic|someone afflicted with lunacy; a crazy person|The man was considered a lunatic because he was talking to a tree as though it were a real person.|
Luncheon|a planned proper function for business or pleasure involving eating |Since the luncheon was cancelled, I was saddened that I would not get to visit with my friends and I would have to fix a sandwich at home.|
Lunge|to make a sudden forward body motion towards someone or something|While visiting my uncle in Florida, he took me to a canal and we watched an alligator lunge at a fish capturing it and started eating it before our eyes.|
Lure|to entice someone or animal with something to persuade them to go somewhere|Ben had to lure the stray dog from the busy road to his yard by offering it a piece of meat until he could find the owner.|
Lure|to tempt a person or an animal into going somewhere else|The hunter used apples to lure the deer out into the clearing.|
Lurid|full of unpleasant details that are meant to shock or interest people|The film had an R-rating because of its lurid depiction of the couple’s sexual encounter.|
Lurk|to hide from sight until the optimal moment in order to attack|Hungry lions lurk in the tall grass and wait for unsuspecting gazelles to cross their path.|
Luscious|extremely appealing in smell, taste, or appearance|I wanted to take a bite of the luscious apple.|
Lush|growing in abundance |Vines and other swinging plants covered the lush rainforest.|
Lust|a fierce desire, often sexual in nature|Janet’s lust for chocolate has caused her to become quite chubby.|
Luster|shine, polish or sparkle|The luster of the holiday lights shone brightly on the freshly fallen snow.|
Lusterless|dull; not shiny|After taking the lusterless ring to the jewelry shop, the once dull piece was now bright and shiny.|
Lustrous|having a glow or radiant look|After a long overdue visit to the hairdresser, my hair is a lustrous auburn color once again.|
Luxuriant|plentiful in detail or growth|In the spring months, thousands of tourists visit the luxuriant gardens near the art museum.|
Luxuriate|to take pleasure in something|After a long day, all Amber wanted to do was luxuriate in a soothing bubble bath.|
Luxurious|a very costly sophisticated style|While traveling abroad with a friend, we were awestruck of the luxurious hotel room we chose.|
Luxury|a state of great comfort, especially when provided by expensive and beautiful things|Living a life of luxury, the queen had people to wait on her hand and foot.|
Lynched|to kill by hanging someone without a judicial trial|There was a time in history when crowds would form to watch someone lynched.|
Lyric|a line of a song or poem|Each lyric of the song must be memorized before the singer takes the stage.|
Macabre|gruesome, shocking, disturbing, terrifying|Since even the scariest of horror movies only made her laugh, Sofia supposed that she had a macabre sense of humor.|
Machiavellian|noted by devious behavior, especially when benefitting one’s career or business goals|My supervisor is very sneaky and has been known to exhibit Machiavellian behavior in order to move up in the company.|
Machination|a scheme that is usually created for bad reasons|After being caught running a machination against his political rival, the ruthless candidate lost the election.|
Machismo|exaggerated masculine pride|A machismo makeover was just what the man needed to increase his masculinity.|
Macrocosm|a large unit or system that contains many smaller bodies|The global company was a macrocosm headquartered in New York City with smaller entities all over the globe.|
Macroeconomics|a division in economics which focuses on the larger aspects of economics of money comparing it to the entire nation or world|When the state’s government analyzes their budget, they use macroeconomics to determine how their budget will influence the country’s budget.|
Macroscopic|able to be seen with the eye|If the item to be examined is macroscopic, then a scientist won't need a microscope to view it.|
Mad|angry or furious|My mother was so mad that she threw a chair across the room in a fit of rage that was completely unrivaled.|
Maelstrom|a situation in which there is great confusion, violence, and destruction, or a very powerful whirlpool|Following the divorce, Judy was beset by such a maelstrom of emotions that she decided to talk to a counselor.|
Maestro|a master of music who is skilled in playing or conducting|Leading the orchestra through their set, the maestro amazed the crowd with his conducting.|
Magic|the ability to persuade people using illusion and trickery|“The only way the man could have made that bird disappear,” said the amazed young boy as he watched the street performer, “is through magic.”|
Magisterial|overbearing and domineering|When my magisterial mother-in-law came over to our house, she insisted that I raise my children exactly how she wanted me to.|
Magistrate|a judge that hears and rules on minor offenses|As a local magistrate, the judge’s power over state issues was limited.|
Magma|rock that is hot and in a liquid form beneath the Earth’s surface|The magma that comes from the ground during a volcanic eruption is referred to as lava.|
Magnanimous|very generous or forgiving; unselfish| Despite the slurs made against him by his opponent, the boxer was magnanimous enough to praise his competitor.|
Magnate|a wealthy and influential business person|Due to his status as a political magnate, many people were eager to vote for him in the next election.|
Magnetic|attractive; alluring|With a magnetic smile, the singer captivated the crowd with his crooning.|
Magnificent|superb or outstanding|With a beautiful bride, delicious cake and fun reception, the guests commented about what a magnificent wedding this was.|
Magnify|to boost or enhance something, making it appear larger|My sister is an exaggerator who likes to magnify even the smallest symptoms when she is sick.|
Magniloquence|use of grand or wordy speech to say something simple|The orator’s display of magniloquence confused the listeners.|
Magniloquent|using high-sounding, boastful language|He spoke in a magniloquent manner, drawing attention to himself.|
Maid|a domestic servant who cleans and waits on others|The maid spent most of her day ironing clothes and folding laundry for her mistress.|
Maim|to injure to the point that function is lost in a body part or region|The evil dictator seemed to take delight in using a sword to maim and murder the people who opposed him.|
Main|the key part or most important part of something|My main job at work is to answer phone calls from customers with questions.|
Mainland|the main landmass of a country or continent|After a wonderful seven day vacation in Hawaii, it was time to go back to the mainland of California.|
Mainstay|a thing that something or someone depends on|Coupons are a mainstay for the couple since they depend on them to reduce their grocery bill every week.|
Mainstream|having the most influential appeal to something accepted by most|In short, modern mainstream media pertaining to politics is in a state of total confusion.|
Mainstream|considered ordinary or usual by most people|The song is popular with pop fans who listen to mainstream music.|
Maintain|to keep something in its current state|In order to maintain my grades at school, I must study hard and complete all of my homework to ensure they stay A’s.|
Maintain|to keep something in its current condition or state|It is difficult to maintain my weight when my diet consists of donuts and Chinese takeout.|
Maintenance|work performed on a system in order to keep it operating as intended|Because the sewer system is such an important part of the city’s infrastructure, we have to conduct maintenance on it every few weeks to make sure everything is running properly.|
Majestic|displaying impressive grandeur|The majestic movie theater was so glamorous it was converted into a film museum.|
Major|main and key|While the teacher was harshly disciplining the class, she was able to get her major point across to the students about keeping their hands and feet to themselves.|
Majority|the greater percentage of the whole|Winners of talent shows like American Idol are decided by a majority vote.|
Make-believe|indulge pretense or invent a story or excuse|Jacob likes to play make-believe he’s Superman by jumping off a chair onto his bed pretending he can fly.|
Make-up|apply various types of cosmetics usually to face to enhance ones look|Adam hates it when it takes me thirty minutes to curl my hair and apply all of my make-up before we can leave the house.|
Make|to bring into being; create, build, produce, etc.|“Would you like me to make you some breakfast?”|
Makebate|a person who causes arguments or starts up trouble|Because she likes to spread rumors, the office makebate is constantly stirring up strife at work.|
Makeshift|an impermanent substitute|During the storm, we used the large tree branches as a makeshift shelter.|
Maladjusted|not able to cope with the demands of one’s life|After being raised by apes, the young lord was maladjusted to the duties expected of him by society.|
Maladroit|awkward and somewhat incompetent|The nervous boy was maladroit and stuttered over his words as he invited the girl to the dance.|
Malady|an illness|Because she is a hypochondriac, my sister has one malady after another.|
Malaise|a feeling of general bodily discomfort, fatigue or unpleasantness|Jason knew he was getting ill because of the malaise he had been experiencing for a few days.|
Malapropism|a comical misuse of a word that resembles another term in sound|In class, everyone laughed at Bill’s malapropism when he complained about electrical votes instead of electoral votes.|
Malapropos|out of place; inappropriate|Her funny remarks seemed malapropos at her sister’s funeral.|
Malaria|a disease spread by mosquito|After my trip, I experienced symptoms that prompted me to get tested for malaria.|
Malarkey|something that is considered to be absurd or junk|Everyone knew that her opinion was complete malarkey since she could not support it with any evidence whatsoever.|
Malcontent|an individual who is unruly and hardly ever satisfied |The woman was such a malcontent that she complained about every dish served to her in the five-star restaurant.|
Malediction|an evil speech or curse upon someone or something|The witch’s malediction made the young princess fall into a deep sleep.|
Malefactor|one who does evil|For several years, the detective pursued the malefactor who had brutally killed the two children.|
Maleficent|harmful or evil in intent or effect|The preacher said that Satan is a maleficent force that urges men to sin.|
Malevolent|wishing harm to others; malicious|How malevolent of you to wish that I was dead!|
Malfeasance|the performance of an illegal deed, generally by someone in the public trust|When the election results are tallied, surely the people will have voted out the mayor who is currently being investigated for malfeasance.|
Malice|desire to cause pain, injury, or distress to another|John’s malice towards his ex-wife led him to vandalize her car.|
Malign|to say unpleasant things about someone or something, usually unfairly|By spreading the cruel rumor, my sister hoped to malign her ex-boyfriend.|
Malignant|causing an extremely serious, possibly even fatal, issue|Crystal cried when she learned the tumor was malignant.|
Malignity|an occurrence of hateful behavior or temperament|Spitting on someone is one of the worst types of malignity a person can inflict upon another person.|
Malinger|to pretend to be sick or injured in order to avoid doing work|When it is time to do work around the house, Henry will offer malinger and go to his room to rest.|
Mall|a shopping center with lots of individual stores house in one building|A new department store is coming to the mall and will be housed between the shoe store and gift shop.|
Malleable|capable of being easily changed or influenced|When my uncle drinks a great deal, he is always quite malleable to suggestions.|
Mallet|a hammer with a typically wooden head that is used for hitting a chisel|With a mallet and a chisel, a skilled sculptor can turn a block of stone into a fantastic statue worthy of being in a museum.|
Malnourished|suffering from a deficiency of proper nourishment |Because the homeless man was malnourished, I gave him money for a decent meal.|
Malnutrition|a lack of adequate nourishment (from not eating enough food or not eating enough healthy food)|Her eyes were sunken in from malnutrition.|
Malpractice|a practice or act that is harmful or negligent|The doctor’s malpractice insurance will handle the court costs associated with the lawsuit filed by his patient.|
Maltreat|to treat someone or something cruelly or violently|The child was in a lot of trouble because of the way he would maltreat our dog, kicking him whenever he was angry.|
Mammoth|very large|We watched as the mammoth whale started doing backflips near our boat, causing waves to splash up against us.|
Manacle|an item that functions as a control or restraint|The manacle will keep the dog from leaving the front yard.|
Manage|to be in charge of something|A new person was hired to manage the newsstand and make sure sales increase.|
Management|the control and organization of something|Classroom management is an important part of teaching students since real learning can’t take place in an unruly classroom.|
Mandamus|a legal order from a higher court to a lower court to perform a required task|In order to fix the problems of justice, a mandamus was required by the Supreme Court to have the State Court execute a state of emergency.|
Mandate|permission to do something |The marshal was given a mandate to use all resources to bring in the escaped prisoner.|
Mandatory|something that is absolutely required and must be done|There is a mandatory meeting that we all must attend as faculty members, so we can have no excuse for being absent.|
Mane|long and thick hair associated with the head of a mammal|After not cutting his mane for forty years, the man had hair that fell to his knees.|
Mangle|to make unrecognizable through violent acts of cutting, slashing, or crushing|The lion's razor-sharp claws mangle the terrified gazelle as he feeds.|
Mania|excessive desire, excitement, or enthusiasm|Greg’s sports mania is so ridiculous that he can watch the same game hundreds of times without getting bored.|
Manic|wildly erratic or frenzied in behavior|During her manic state, the woman with bipolar disorder spent lots of money and acted unpredictably.|
Manicure|treatment for the hands that involves softening the skin and making the nails look better|The full manicure treatment is more expensive because it includes nail cutting and painting.|
Manifest|easy to understand or recognize; obvious |The love on Amy’s face was manifest and obvious to everyone.|
Manikin|a model of the human body, used for teaching medical or art students|Because the science manikin is so realistic, it has pupils that react to light and eyelids that blink.|
Mankind|the human race|Pollution prevention is good for mankind because the human race can’t continue without fresh air.|
Manner|the way in which something is done|The toddler acted in a horrible manner, screaming and throwing a fit in the middle of dinner.|
Mannerism|a certain way someone speaks, acts or behaves|Even though I couldn’t see the girl standing away from me, I knew it was Samantha due to her mannerism of talking.|
Manor|the big house on a large estate|The lord’s manor is a grand house that sits on a thirty-acre estate.|
Mansion|a large, impressive house, most often owned by someone wealthy|Because he has millions of dollars at his disposal, the man decided to buy a massive mansion to showcase all of his wealth.|
Mansplain|to explain something that you don’t understand completely (from man to woman) in a way that is considered patronizing|During meetings, my male coworkers are more likely to dominate the conversation and condescendingly mansplain things to the women.|
Mantic|a person who can tell or see the future|After looking into his crystal ball, the mantic was able to tell the woman who she was going to marry.|
Manticore|a mythical creature that was said to have a scorpion’s sting but the body of a lion and head of a man|According to the myth, the manticore’s sting is as strong as a scorpion while his body is that of a lion.|
Mantle|the obligations or authority associated with an individual’s duties, title, or personal beliefs|Overwhelmed by the stress that came with the mantle of his office, the prime minister resigned from his position.|
Manual|a booklet that instructs someone on how to do something or the usage of something|Tom was able to troubleshoot why our newly purchased television wouldn’t work by reading the manual.|
Manual|a book or booklet that gives instructions or explains how something works|My wife’s new vehicle came with a manual that explained all of its features.|
Manufacture|to create items on a massive scale|The company is relocating production to Asia because it is cheaper to manufacture products overseas.|
Manumission|release from slavery, freedom|When manumission happened on the plantation, all the slaves were freed.|
Manuscript|text that has been typed or handwritten as part of the preparation for publication|After I read the first ten pages of Cameron’s manuscript, I couldn’t wait to finish the rest of the screenplay.|
Mar|to ruin or spoil|You will mar the cake if you keep putting your fingers in the icing.|
Marauder|an individual who is constantly looking for something to steal|The marauder uses his quick hands to rob people on public buses.|
Marauding|moving from one location to another in order to commit crimes against society|The marauding thieves never stay more than a few nights in a city.|
Marble|a type of lined rock that is very hard and can be polished to become smooth and polished|Polished marble was used for the kitchen counters, but a different type of stone was used for the flooring.|
Margin|the edge or border of something|Students should not write outside the margin but instead stay inside the lines.|
Marginal|minor; not of consequence|I was not upset by the marginal price increase.|
Marginate|having a distinct border, or ‘margin'|Every country is marginate in nature, having a distinct border that determines how much territory that country controls.|
Marine|found in or produced by the ocean|The marine animals are dying because of trash and pollution being dumped into the ocean.|
Marine|a member of a military force trained for service at sea|Cathy was so excited to hear that her nephew Harry is officially a Marine after he recently graduated from boot camp.|
Maritime|related to the sea or sailing|After recently purchasing a boat, they decided to embark on a maritime adventure.|
Marketplace|an place where people sell things to the public|Vendors are selling rugs, pottery, and other wares in the open marketplace.|
Maroon|a dark reddish-tan color|Since the young man knew nothing about fashion, he wore his maroon shirt with a lighter red pair of pants.|
Marquee|a structure placed over the entrance to a hotel or theatre, stating either the name of the establishment or the play or movie and the artists appearing at that venue|The old theater in town had a marquee sign that still read, “Now Showing: The Wizard of Oz”.|
Marred|spoiled or damaged|The rowdy college boys marred the hotel room.|
Marriage|the legally recognized joining of spouses|After twenty years of marriage, the once happy couple is now divorcing.|
Marrow|the center soft part of the bone that produces blood cells|When the bone broke, it exposed the marrow to the germs which might have led to an infection.|
Marsh|an area of low-lying land that is floods often and sometimes remains waterlogged|The marsh and other wetlands in the area are protected by land conservation laws.|
Martinet|an individual who emphasizes discipline|As a colonel in the army, John is a martinet who believes discipline is the only path to success.|
Martyr|one who surrenders something of tremendous value for a cause|The gay man became a martyr when he lost his job after refusing to hide his sexual preference.|
Marvel|something or someone that triggers amazement|Many scientists view the three-year-old boy with the extremely high IQ as a marvel.|
Marvelous|something showing amazing talent or skill and that often inspires awe|The actress was so marvelous at her role that she not only won an Academy Award but brought everyone in the audience to tears with her performance.|
Marxism|a social and political theory that is the opposite of capitalism and argues that production and all of the means of public ownership should lie in the hands of the workers|The socialist theory of Marxism says that people are grouped into categories based on their relationship to how things are made.|
Masculine|manly or seen as male in nature|It is considered masculine to be big and strong, though that notion is probably from an older era where men were usually warriors of some sort.|
Masochist|an individual who gets pleasure from suffering| Sarah does not like enduring or observing pain so she is definitely not a masochist.|
Masquerade|to assume a false identity |The con man decided to masquerade as a missionary to bilk the church out of its savings.|
Mass|a heap or pile|A mass of garbage continued to pile up outside of the smelly dumpster.|
Massacre|killing of many people|The French massacre was particular bloody, with over one hundred lives lost.|
Massive|large and heavy|As a college freshman, I was surprised to be given a massive textbook which I could not carry alone.|
Mast|a tall post attached to a ship that holds sails|The mast had a sail attached and was used to guide the boat.|
Mastermind|a brilliant thinker who uses one's intellect to put together plans or projects|Though Joe was the mastermind behind the bridge’s design, his boss took all the credit for the architect’s magnificent blueprints.|
Masterpiece|an outstanding work or skill|Staring at the blank canvas, the artist pondered how he could turn this slate into a world-renowned masterpiece.|
Mastery|complete control or superiority over something else|Man’s mastery over nature in our world allows us to achieve many things, but even so we can never outmatch nature’s raw power.|
Masticate|to chomp with teeth; chew|My mother told me to never talk while I masticate my food.|
Match|a contest in which people or teams compete against one another|During the close match, the boxing champ made a mistake and was knocked out by his opponent.|
Mate|each of a pair of items|Erica became upset when she couldn’t find the other mate to her favorite pair of socks.|
Material|matter or substance of which something can be made|Because the dress is made from an expensive material, the shop owner will sell it for a higher price.|
Materialism|constant concern over material possessions and wealth|Obviously, the shopper’s belief in materialism led her to buy far more items than she could afford.|
Materialize|to become real or visible|If you want to make your dreams materialize, you must take steps to make them real.|
Maternal|related to or associated with a mother |The cat’s maternal instincts led her to adopt the lost puppy.|
Matriarch|a woman who leads a tribe or family|My mother is the family matriarch who has the final say in household affairs.|
Matriarchy|a family unit, group, or administration managed by a single woman or a team of women|The tribe of female warriors has always been ruled by a matriarchy.|
Matriculate|to become a student at a school, especially a college or university|After high school, I will matriculate at a local community college.|
Matrilineal|associated with the female line of the family|Since my mother and two of my sisters have died from cancer, I can only assume the disease is matrilineal.|
Matrimony|the state of being married|The man and woman are in a state of holy matrimony, being not just a man and woman but a husband and wife.|
Matrix|an environment in which the development or formation of something occurs | In the film, an alternate world had developed inside of the matrix.|
Matron|an older, serious-minded married woman who usually has a high social position|The matron was highly regarded for her philanthropic endeavors in her community.|
Matronly|used to describe a middle-aged, married woman who is plump and dresses in a plain way|The more matronly customers selected long skirts and flats rather than mini-skirts and tall boots.|
Matte|describing a color that is dull and has no shine|This brown color is extremely matte, dull and lifeless but supposedly a good color for this piece of furniture, according to my mother.|
Matter|be of importance of have significance|Clara insisted that the messiness of her room shouldn’t matter, but her mother thinks keeping a clean house is important.|
Matter|a substance or object that occupies physical space|The matter changed from a solid to a liquid form when it was placed in the sun to melt.|
Mature|to gain experience or wisdom with age; full grown|Emily said to her children, “Instead of calling each other names, can we discuss this in a mature manner?”|
Maturity|of full development|When the cherry tree reaches maturity, it will produce fruit.|
Maudlin|showing or expressing too much emotion especially in a foolish or annoying way|The girl’s performance was so maudlin that people started to boo her off the stage.|
Maul|to wound someone by scratching or tearing them, often used in reference to animals|I would never go near a bear even in captivity, for fear that it would maul me with its huge teeth and claws.|
Mauled|attacked and mangled|Because it seemed friendly, neighbors were surprise to hear the dog had mauled a pedestrian.|
Mausoleum|a large elegant building that holds tombs|The king wants to be entombed inside of a mausoleum.|
Maxim|a phrase that is often used as a guiding rule|My grandmother had a wise maxim to help me get through all of my teenage crises.|
Maximize|to increase something in size, amount, or importance as much as possible|If you increase your advertising in certain areas, you may also be able to maximize profits for your products.|
Maximum|the highest amount possible|After the opening of Pandora at Disney World, the park was forced to closed their doors because they had reached the maximum number of guests allowed in the park at one time.|
Maximum|the total amount or limit|We are looking for a house with a maximum of four bedrooms because any more than that would be too many.|
Mayhap|perhaps or possibly|Mayhap we should leave this cave before we encounter whichever creature calls it home?|
Mayhem|chaos or disorder|During the busy holiday season, most of the stores seem to be in a constant state of mayhem.|
Meager|very small or too small in amount|My daughter is quick to complain about what she considers to be a meager allowance.|
Mean|characterized as cruel or antagonistic, but often in a petty manner|A mean bully might try and take your lunch money from time to time, but such things are hardly unspeakably cruel.|
Meander|to move slowly without any real purpose|The confused old man will sometimes come into the store and meander for hours without making a purchase.|
Meaningful|having a serious, important, or useful quality or purpose |Whenever she tried to have a meaningful conversation with her boyfriend, he always changed the subject to a new cat video or trending meme.|
Meant|the past tense form of mean that is used to express what someone intended or had in mind|I meant to send off the package, but left it sitting on the kitchen counter.|
Meanwhile|at the same time but elsewhere|“Victoria, dinner will be ready in ten minutes, meanwhile please set the table.”|
Measly|an extremely, almost laughably small amount|Briana hoped her mother would pay her well for babysitting her brothers but she only got a measly $5.|
Measure|to gage or calculate an amount|Using a cup to measure ¼ cup, the chef sifted just the right amount into the bowl.|
Measurement|the size or length of something|The seamstress guessed the measurement of the man’s shoulders and then confirmed with her tape.|
Mechanical|linked to machinery or tools|A mechanical engineer was needed to fix the broken conveyer belt.|
Mechanism|a piece of a machine that plays a specific role in its operation|Visitors were stuck on the Ferris wheel for hours when the mechanism that controlled the rotation stopped working.|
Medallion|a piece of jewelry crafted in the shape of a medal, often worn around the neck as a pendant|The officer received a spectacular medallion from his commander in chief, a medal to wear around his neck for his service in the war.|
Meddle|to interfere in something that is not your concern|Because my mother-in-law is trying to meddle in my marriage, I want her out of my house immediately.|
Meddlesome|tending to interfere in other people’s affairs|Meddlesome men spent their morning drinking coffee and discussing their neighbors business.|
Medial|situated in the middle of something|With three people standing in a line, the person in the middle of the line has a medial position.|
Median|the middle number of a set of ordered numbers|The median household income for this major city is $56,000 with half of the lower incomes being below that amount and the higher incomes being above that amount.|
Mediate|to help solve conflicts|My husband is the one who usually has to mediate the disagreements between our sons.|
Mediator|one that serves as a go-between during a dispute|A mediator was needed to help the divorcing couple come to an agreement.|
Medicare|a free health insurance program in the United States for older or disabled people|Since my elderly mother has poor health, Medicare is her supplier of health care should she need medical attention.|
Medicinal|used to cure pain and diseases|Medicinal herbs were added to the tea to cure the woman’s stomachache.|
Medicine|a substance used to treat disease|Without medicine to ease his headache, the man had no choice but to go to bed early.|
Medieval|relating to the Middle Ages|Medieval feasts were thrown for royalty and nobles during the Middle Ages.|
Mediocre|average; not great or extraordinary|Because Janice does not apply herself in school, she is a mediocre student.|
Mediocre|of ordinary or average quality|The mediocre meal wasn’t the worst I’ve had, but it wasn’t the best either.|
Mediterranean|representative of the Mediterranean Sea or culture of the people surrounding it|Her olive skin and dark hair was typical of a Mediterranean woman.|
Medium|in between small and large|When trying on a swimsuit, Carrie chose a medium since the small was too tight but the large was sagging.|
Medley|a mixture of things|A medley of horrific shouts rose up out of the crowd when they realized the concert was canceled.|
Meed|a much deserved reward or honor|Even though she had six children, the loving mother was able to give each a meed of her time and attention.|
Meek|restrained; unwilling to speak up|Although the meek girl knew the answer to the teacher’s question, she was too nervous to raise her hand.|
Meekly|doing something in a humble and modest way|The shy girl hung her head as she meekly followed behind her older sisters.|
Meeting|a gathering of people coming together|Once managements gathers more information we will notify everyone for another meeting soon.|
Megabyte|a unit equal to one million bytes that is used to measure how much information a computer can store|The disk contained one megabyte of storage space.|
Megalith|a large stone that was used as a building block in prehistoric structures|A gigantic megalith was used to create a stone graveyard in 3000 B.C. Germany.|
Megalomania|a mental disorder that leads individuals to think they are more influential and powerful than everyone else|Helen’s megalomania allowed her to believe she could drive under the influence without putting her life in jeopardy.|
Megalopolis| a region comprised of several big cities|As the cities in the area have grown, the population of the megalopolis has greatly expanded.|
Megaton|an explosive force measurement that is used for nuclear weapons (equals one million tons of TNT)|The megaton missile exploded with great force as it reached its target.|
Megawatt|a unit for measuring electricity that is equal to one million watts of power|The current national average of homes powered by a megawatt of solar power is 160.|
Meiosis|a cellular process in which a single cell divides twice to produce four cells containing half the original amount of genetic information|During meiosis, the parent cell duplicated and recombined to produce new cell.|
Melancholy|a feeling of deep sadness|The film’s tragic ending put us all in a melancholy mood.|
Meld|to blend or merge things together|Singing in harmony, the musicians were able to meld their voices.|
Melee|a brawl, riot or fight|I hate to go shopping during the holiday season because it feels like a melee with everyone pushing and shoving in the aisles.|
Meliorate|to improve or make something better|As a counselor, it was his job to try and meliorate the relationship between the two family members.|
Meliorism|the idea that human effort is the key to making the world a better place|As a believer in meliorism, the activist felt that every small effort he made had a positive effect on the world.|
Melliferous|bearing or producing honey|Melliferous flowers were collected to make honey.|
Mellifluous|having a smooth, flowing sound|The actor has a mellifluous voice that could lull anyone into a deep sleep.|
Mellow|to become calm and easy-going due to being older or having more practice|My mother became mellow once she became a grandmother because she would never let me eat unhealthy foods that she feeds to her grandchildren.|
Melodious|having a pleasing sound|His melodious voice carried over all of the other students in the Christmas program.|
Melodramatic|overemotional|For the practical viewer, the soap opera was way too melodramatic.|
Melody|a simple tune that sounds harmoniously|When the singer sang the song, her voice belted out the beautiful lyrics against the backdrop of the melody.|
Melt|to dissolve something solid through heat|The ice at North and South Poles is beginning to melt now that the temperature of our atmosphere is starting to rise.|
Membership|an individual becomes a member of a club, group, or organization|Amanda was pleasantly surprised to receive a one year membership to a local fitness center for a birthday present paid for by her children.|
Memento|a keepsake; an object kept as a reminder of a place or event|The necklace I received from my late husband is a loving memento from my time spent with him.|
Memo|a written message, especially in business|The manager of the finance department sent a memo out to employees telling them when the next meeting would be held.|
Memorabilia|items treasured by people due to their past fascination in a remarkable person or occasion|Due to the baseball memorabilia scattered across the garage sale table, the patrons realized that the homeowner brought home many souvenirs from the baseball games he attended.|
Memorable|notable and unforgettable|By marrying her soulmate on her perfect day, Beverly knew this would be the most memorable event of her life.|
Memorandum|a short note about a specific situation serving as a reminder|The Human Resources Department sent out a memorandum to all of the employees with the information pertaining to the upcoming holiday party.|
Memorial|something serving as a remembrance of someone or event|There was so many people today who attended the memorial of a young girl killed by her father.|
Menace|an individual or situation that causes problems|My neighbor’s dog is a menace who seems to enjoy going potty on my porch.|
Menagerie|a diverse collection|The president expected a menagerie of questions from the group of reporters.|
Mend|to repair or fix something that is broken or damaged|There’s no way to mend my broken shoe, so I’ll just need to buy a new pair.|
Mendacious|lying; not telling the truth|Chuck is mendacious about his vegetarianism because he eats chicken.|
Mendacity|lack of honesty|Since honesty is very important to me, I was deeply offended by my ex-husband’s mendacity.|
Mendicant|an individual who begs for a living|The mendicant hoped pedestrians would drop money in his bucket.|
Menial|relating to tasks normally performed by a servant|Everyone was surprised to see the company president doing menial labor he could easily pass on to one of his employees.|
Mental|relating to the mind or to the health or state of one's mind|The teacher’s mental strength was tested when the principal was observing her.|
Mentality|a pattern of thought|The stern preacher’s mentality was that any music other than Christian music had sinful overtones.|
Mention|to make a short reference to something|I will mention to your father when he calls me from work that he needs to take you to your baseball game tonight.|
Mentor|someone who teaches or gives advice to someone less experienced|Because she was a new teacher, Betsy needed a mentor to show her how to set up her classroom.|
Mephitic|Bad-smelling; having a foul odor especially of gas or vapor|The car’s mephitic fumes choked up the passengers in a nearby sedan.|
Mercantile|concerned with the buying and selling of goods for money|I joined our family’s mercantile business, buying and selling paper goods.|
Mercantilism|an economic system in which a nation tries to become more affluent by exporting more goods than it brings into the country and by protecting its store of precious metals|One of the reasons England developed the colonies under mercantilism was to increase its trading territory.|
Mercenary|motivated by private gain, regardless of ethics or laws; greedy|Following his employer’s instructions, the mercenary killed the woman and her baby without a second thought.|
Merch|a shortened form of the word merchandise (products that people sell)|We went to the clothing store for new merch but didn’t find any eye-catching pieces.|
Merchant|one who trades in goods to earn a profit|The greedy merchant raised the price of bread and milk during the blizzard.|
Merciful|compassionate and generous|After winning the lottery, the merciful winner donated every penny of her winnings to the homeless shelter.|
Merciless|without mercy. ruthless and unforgiving|The merciless sun of the desert will quickly drain all travelers of both water and will, ensuring a painful demise if one does not enter its sands prepared.|
Merciless|cruel and without mercy or pity|The merciless dictator killed everyone that went against his regime.|
Mercurial|subject to sudden or unpredictable changes|Because Mary is taking a new medication, her moods have become quite mercurial and change with the wind.|
Mercy|tendency towards forgiveness, pity and kindness|Beth’s strict parents showed mercy after she missed her curfew because she helped a stranded female motorist by jump starting her car battery.|
Mere|in regards to an individual or thing that is viewed as unimportant or small|Although Bailey was a mere boy, he knew he would become a world leader one day.|
Merely|only, just, and nothing more|The knight wondered how he, being merely a man, could hope to defeat the dragon.|
Meretricious|tastelessly showy; attractive on the surface but having in reality no value or substance; falsely alluring|Because of Christie’s meretricious style of dressing, she has often been mistaken for a prostitute and has received a number of indecent proposals.|
Merge|to come together into one unit|When the struggling nursery was about to go bankrupt, it decided to merge with the seed store since they both were in the same business.|
Merger|the joining of two things into one|The merger of the two companies happened in February when the smaller corporation joined the larger.|
Meridian|an imaginary line that passes from the North Pole to the South Pole|The equator and the prime meridian are imaginary lines used to find longitude and latitude on a map.|
Meringue|a pie topping that is browned after being made from beaten egg whites and sugar|Edith whipped up a meringue to be added to the list of sweet and light treats.|
Merit|something that deserves to be recognized or praised|Jill earned an award of merit for never missing a day of school in twelve years.|
Meritocracy|a system in which the leaders are chose based on intellect, talent, or merit, not other factors such as race, popularity, or economic status|Mr. Young longed to live in a meritocracy where the leaders of the free world were the ones who earned their places based on their accomplishments.|
Merriment|laughter, happiness, and enjoyment|The party was filled with the wonderful sounds of merriment.|
Mesh|to connect or lock together|The band can’t seem to mesh well together and continuously play off key.|
Mesmerized|captivated by something or someone|Because Jennifer was mesmerized by the author’s writing style, she purchased all of his books.|
Mesosphere|an area between two layers in the Earth’s atmosphere where it gets colder as the elevation increases|In the mesosphere the alien spaceship recorded the increasing temperatures every few minutes in this layer as it came closer to Earth.|
