Aardvark|a large, long-eared nocturnal animal that uses its long tongue to eat ants and termites|The long-eared aardvark slept all day and ate insects all night.|
Abaft|toward the stern; behind|The wind was abaft which made the ship glide faster towards our destination.|
Abandon|to stop caring and leave or to desert|Since the young girl was unable to care for the newborn, she decided to abandon the child at a fire station.|
Abase|to lower so as to hurt feelings|My stepmother is an evil woman who likes to abase little children because she had a miserable childhood herself.|
Abaser|someone who degrades or lowers someone|After the abaser would make fun of her daughter-in-law’s cooking, she would then continue to talk bad about the young woman’s appearance as well.|
Abash|to humiliate someone and make them feel embarrassed or ashamed|The officer tried to abash the inmates, humiliating them and treating them like dogs.|
Abate|to reduce in degree or intensity|I hope this medicine will abate the pain in my leg.|
Abatement|reduction or weakening or something|Natalie longed for the abatement of the screaming rock music from her brother’s band so she could focus on her homework.|
Abattoir|a place where animals are taken to slaughter|Although many farmers own cattle, they don't slaughter the animals on site but send them to an abattoir.|
Abbess|the female superior of a community of nuns|An Abbess is the female leader of a small community of nuns.|
Abbreviate|to shorten a word or phrase|Learning to abbreviate long words will help the court reporter type more quickly.|
Abdicate|to stop accepting a particular responsibility or obligation that you have|The young prince became king after his older brother decided to abdicate the throne.|
Abdominal|related to the abdomen/stomach, or the part between the thorax and the pelvis|My severe abdominal pains sent me to the hospital where I learned that it was nothing more than trapped gas.|
Abduct|to grab an individual by trickery or force|The kidnappers planned to abduct the millionaire’s daughter.|
Abecedarian|alphabetical|We decided to organize the files in an abecedarian manner so we could find what we were looking for by name more easily.|
Aberrant|straying from the normal or right way|John’s aberrant behavior is going to get him in a lot of trouble one of these days.|
Aberration|deviating from what is normal or desirable, not typical|Shelley’s angry retort was an aberration from her normally quiet demeanor.|
Abet|to encourage or support a behavior or action|The photo editing software is sure to abet my odds of winning the photo competition.|
Abeyance|a state of temporary disuse or suspension|Immediately following the terrorist attack, pilots had to observe a period of abeyance where they could not depart from the airport.|
Abhor|to reject something very strongly; hate|I abhor liars.|
Abhorrence|a strong feeling of hate paired with a feeling of loathing|My abhorrence of racism makes me avoid people with racist attitudes.|
Abhorrent|causing or deserving strong dislike or hatred|As I looked around the filthy apartment, I had to wonder who could live in such abhorrent conditions.|
Ability|the skill or capability to do something|The Flash has the ability to run faster than the speed of light.|
Abiotic|abiotic means something that is sterile; not from living organisms|Unlike alive biotic organisms, abiotic factors are nonliving.|
Abject|cast down in spirit or hope|After his wife died, he was an abject man.|
Abjure|to give up a belief or an activity|After the tyrant took over the country, the citizens had to abjure their political beliefs.|
Ablaze|burning fiercely; in a blaze; on fire|The cops threw Jack to the ground and arrested him after he set the American flag ablaze.|
Able-bodied|physically strong and healthy|If you are not injured or sick, you can generally be considered an able-bodied individual capable of physical exertion.|
Able|having the capability of doing something|Being a healthy young man, I am perfectly able to engage in manual labor, no matter what kind of physical stress that includes.|
Ablution|the act of washing or cleansing|Sylvia has a rare condition that makes her break out in a rash if she gets water on her skin, so her morning ablution consists of using cleansing cream and tissue.|
Abnegation|the act of rejecting or refusing something |Her abnegation of ice cream and cookies is due to her Olympic team training.|
Abnormal|out of the ordinary; unusual|William worried that his abnormal bleeding was a symptom of cancer.|
Abnormality|a feature that is not normal or average|Albinism is an abnormality in the pigmentation of one’s body, making them so pale as to appear white.|
Aboard|on board, into or within a ship or boat|The stewardess welcomed everyone aboard and asked us to pay attention to what she had to say.|
Abolish|to put an end to|The Supreme Court believed it was time to abolish the outdated amendment.|
Abolition|the action of putting an end to something|The abolition of smoking in restaurants is a blessing to people like myself who suffer from allergies and asthma.|
Abolitionist|one who supports the elimination of practices or laws that are viewed as dangerous|The abolitionist is recruiting like-minded people who share her opposition to the pro-abortion laws.|
Abominable|horrible; terrible|Last year’s record final record was abominable and we finished the season with no wings.|
Abominate|to despise intensely|Since I abominate liver, I will starve to death before I eat it.|
Abomination|something that is hated|The marketing team thought the new ad to be an abomination and worked hard to come up with one they didn’t hate.|
Aboriginal|associated with being part of the original population; native|The Indian tribe’s aboriginal dialect has been replaced by the English language.|
Abort|to stop something from happening any longer; to discontinue|The law allows women to abort an early-stage pregnancy.|
Abound|available in large quantity or number|At the beginning of the school year, computer deals abound on the Internet.|
Above|overhead or directly over the head|As the children heard the airplane, they looked above to see the big Boeing 747 flying within inches of the treetops.|
Above|at a higher layer or level than something else|If you look above you while outside, you will almost certainly spot clouds, the sun, or the moon, though in some cases you might not see them at all.|
Abraded|to produce damage or irritation by scraping, rubbing, or crushing|The wool blanket abraded my legs and gave me a rash.|
Abrasion|a spot or area that has been scraped or harshly rubbed|When the little boy fell off his bike, his only injury was a small abrasion on his right leg.|
Abrasive|unlikeable; nasty|Because of Kurt’s abrasive personality, most people try to avoid him at work.|
Abreast|remaining up to date on a topic|To stay relevant in the field of computer programming, Kurt must stay abreast of the latest programming languages.|
Abridge|to make shorter|His agent told him that he needed to abridge some of the content of his novel so that it would be under 400 pages.|
Abroad|in foreign countries|His plan is to get a degree in economics and then work abroad for a year.|
Abrogate|to abolish; to do away with|You cannot abrogate anyone's right to free speech!|
Abrupt|without notice; sudden|The bus came to an abrupt halt outside the school.|
Abruption|a sudden breaking away|During Tara’s pregnancy, placental abruption occurred when the placenta pulled away from the uterine wall.|
Abscess|cavity filled with pus|A tame rabbit was brought in with a large abscess about the size of an egg on its cheek.|
Abscission|the natural shedding of parts of a plant|Abscission of leaves occurs during autumn, before winter sets in.|
Abscond|escape into hiding; to leave quickly and hide to avoid punishment|Do you think he has plans to abscond with the stolen money?|
Absence|being gone from a place or person|She felt his absence like a gaping hole in her chest that was too painful to ignore.|
Absent-minded|describes a person who is forgetful or constantly distracted|The absent-minded professor was always forgetting an ingredient or two in his experiments.|
Absent|not present; not in a place one is expected to be|The absent father never came to his kids’ school events or picked them up for a weekend visit.|
Absenteeism|the practice of missing school or work without good reason|The student’s absenteeism has caused him to miss a lot of work.|
Absolute|complete or total, undisputable|The fact that two plus two equals four is absolute in mathematics, and cannot ever be disputed with any logical argument.|
Absolutely|with no limitation, restriction, or caveat|My cousin is absolutely convinced that there are aliens out there, even though we have no concrete evidence to back up such a notion.|
Absolution|setting free from guilt, sin or penalty; forgiveness of an offense|The killer got on his knees and begged for absolution at his execution.|
Absolve|to make (someone) free from guilt, responsibility, etc.|The jury’s innocent verdict appears to absolve the defendant of any guilt.|
Absorb|to take in or soak up a substance|A sponge will absorb any water it is placed in quite well, since it is porous and designed for exactly that purpose.|
Absorption|the act by which one substance takes in something or is taken in|The paper towels are thick, and as such, have a heavy absorption rate.|
Absquatulate|to depart hurriedly|Before the thief could absquatulate with the diamonds, he was surrounded by police officers.|
Abstain|restrain oneself from doing or enjoying something|Because of my health, I am going to abstain from the consumption of alcoholic beverages.|
Abstemious|marked by moderation and holding back on indulgence|Gerald was abstemious at dinner and only ate a little of the food on his plate.|
Abstention|a decision to not vote for or against a proposition|I decided to settle on an abstention when the family voted on where we should eat, as personally I didn’t care where we went.|
Abstinence|the act of not taking part in something|According to my religion, one should refrain from having sex and practice abstinence until marriage.|
Abstract|being present as an idea but not in a definite form|I cannot distinguish any defined shapes within the artist’s abstract painting.|
Abstruse|difficult to understand|Some of the classic novels are too abstruse for beginning readers to understand.|
Absurd|ridiculous, silly, foolish|Spending the week in jail for stealing a loaf of bread is an absurd punishment for such a minor crime.|
Absurdity|the quality of being ridiculous|To believe that the earth is flat is an absurdity.|
Abundance|a large quantity; many|We're wishing you two an abundance of love and happiness.|
Abuse|Improper treatment|All abuse, whether physical, verbal, psychological or sexual, is bad.|
Abuse|to treat a person or animal in a cruel or mean way|Mean little Griffin used to abuse his dog by kicking and hitting him when his parents weren’t looking.|
Abuse|to mistreat or misuse something|The evil man would always abuse his dog, kicking and hitting the puppy for no reason.|
Abusive|describing continuous violence or cruelty towards something or someone|It is sad to think that many animals suffer at the hands of an abusive owner every day, being physically beaten or deprived of nutrition on a regular basis.|
Abut|to touch or lean on|The chair abuts the wall because it is missing a leg and cannot stand up otherwise, though sitting in it is still risky.|
Abysmal|very bad|Since Troy did not study for the test, he earned an abysmal score on the exam.|
Abyss|an area that appears endless and immeasurable|If you’re an alcoholic, the temptation to drink may seem like a huge abyss.|
Academia|the environment associated with researching, teaching, and learning at a college or university |Gail found the real world of business to be quite different from what she learned in academia.|
Academic|school-related; educational|The academic magazine was full of tips for both teachers and students.|
Academy|a school or place of training in which some special art is taught|The military academy trains up to 2,000 officer cadets each year.|
Accede|to agree with someone or give in to his or her wish|At your insistence and to avoid a prolonged argument, I will accede to your contract terms.|
Accelerate|to increase the motion or growth|It was fun to watch the racecar accelerate from zero to one hundred and fifty miles per hour.|
Acceleration|an escalation in pace or speed|With a little acceleration on my part, I should be able to catch up with the mailman’s truck.|
Accent|a distinctive pronunciation of language often associated by nationality or culture|If you ever meet someone from another country, you will likely note that they have an accent when they speak your language.|
Accentuate|to highlight |The bright colored eyeliner will accentuate Ann’s beautiful eyes.|
Accept|to agree to take or receive|Cinderella tried to accept the prince’s invite to the ball, but her stepmother got in the way.|
Acceptable|satisfactory; adequate|Savannah’s grades were acceptable, but her parents had hoped she would score higher than average.|
Acceptance|the act of taking/receiving something that is being offered|Acceptance of the offer means we will be selling our house to the Jeffersons.|
Accepting|agreeing to take or receive something|Accepting his assistant’s resignation was difficult for the attorney because he didn’t want her to leave.|
Access|gain entrance to|She could no longer access her bank account because there had been too many suspicious purchases.|
Accessible|capable of being accessed|The hotel offers accessible rooms for its handicapped guests.|
Accessory|an article that completes one's basic outfit, such as a scarf or gloves|This silk scarf is the perfect accessory for stylish summer evenings.|
Accident|unexpected event with negative consequences|By accident he touched the hot metal, and yanked his hand away with a cry of pain.|
Accidental|something happening unplanned or unforeseen|Since the boy wasn’t looking, stepping on his friend’s foot was an accidental occurrence.|
Acclaim|public praise and applause|Showered with acclaim, the dancer loved all of the praise she was getting from the crowd.|
Acclamation|loud praise or approval|Debra’s staff works tirelessly and deserves every acclamation.|
Acclimate|to adapt to a new place or different conditions|When you go up into the mountains, allow yourself a little time for your lungs to acclimate to the high elevation.|
Acclivity|an upward slope|We scrambled up the acclivity to view the setting sun.|
Accolade|an acknowledgement or an award|When the police officer was offered the plaque, he refused to accept an accolade for doing his job.|
Accommodate|to fulfill a request or meet the needs of |When I told my manager I was going to school at night, he told me he would try and accommodate my preference to work on the day shift.|
Accommodating|inclined to make happy or content|The accommodating hostess made sure everyone had enough to eat at the party.|
Accommodation|a place for someone to live, stay, or work|The only accommodation offered is a thin old mattress.|
Accompanied|joined by an item or a companion |The rain was accompanied by thunder and lightning.|
Accompaniment| a thing which is provided as a supplement to something else|The accompaniment of the violin really took the song to a new level of sophistication.|
Accompany|to go along with something or someone|According to the menu, a side salad and rolls will accompany the steak.|
Accompanying|appearing or going along with someone or something else|In next week’s newspaper, my article and accompanying photo will be printed.|
Accomplice|a person who helps another person perform a task that is usually criminal in nature|The police are hoping the accomplice will lead them to the mastermind of the crime.|
Accomplish|to achieve or complete something|Even though I used to be pretty bad at mathematics, through hard work and dedication I was able to accomplish my goal of getting an A in the class as my final grade.|
Accomplished|to have achieved or completed something successfully|The committee met for several hours, but accomplished nothing because they argued the whole time.|
Accomplishment|a goal or success that is achieved because of hard work|Being the first one in my family to graduate from college is an accomplishment that I’m very proud of.|
Accord|agreement or concurrence of opinion|The entire table was in accord that mozzarella sticks would be the appetizer.|
Accordance|to be in compliance with something or someone|The company refunded the customer’s money in accordance with their request based on the company’s money back guarantee.|
Accordingly|in a suitable way|Once the payment is received, we will process your order accordingly.|
Accosted|forcefully confronted|When the man accosted me with a gun, I quickly handed over my purse.|
Account|a statement of facts or occurrences|He gave a very vivid and often shocking account/description of his time in prison.|
Accountability|the state of being accountable; responsible for|Their lack of accountability has corroded public respect for business and political leaders.|
Accountable|held as liable for a person or thing|The boy lied because he didn’t want to be held accountable for breaking his neighbor’s window.|
Accounting|the system of recording and managing financial transactions and accounts|The millionaire hired an accounting firm to take care of his financial accounts.|
Accoutrement|an accessory used in a specific situation or for a specific task|The only accoutrement missing from my kitchen is a hand mixer.|
Accredit|to bestow official approval upon |During the ceremony, the dean will accredit students who met the graduation requirements.|
Accreditation|formal endorsement of a person, school program, or organization|When the school lost its national accreditation, it saw its enrollment dramatically decline.|
Accretion|act of increasing by natural growth|The accretion of traffic accidents and drunk driving was attributed to the opening of the new downtown mall.|
Accrue|increase|Even though a traditional savings count will accrue a small amount of interest every year, other types of investments are better hedges against inflation.|
Acculturation|a course by which a person’s or group’s culture is altered as a result of contact with another culture|Many immigrants have forgotten their native cultures because of acculturation in their new countries.|
Accumulate|to pile up or collect|I will accumulate wealth due to disciplined investing.|
Accuracy|the state of being correct or precise|The archer’s accuracy is spot on and he always hits his target.|
Accurate|without mistakes|Since you did not type in the accurate pin number, you cannot withdraw funds from the ATM.|
Accurately|exactly, precisely|It's still not possible to accurately predict the occurrence of earthquakes.|
Accusation|a charge or claim against someone in which they are accused of doing something wrong or illegal|The defendant denied the accusation and held firm that he was not guilty.|
Accusation|a charge or claim that someone has done something illegal or wrong|An accusation of murder was made against the man, but there was no evidence to prove he killed his friend.|
Accusatory|blaming a person or group for something|My wife’s accusatory questions are starting to disrupt our marriage.|
Accuse|attribute blame to someone|Due to Peter’s location at the time of the incident, the police would accuse him of being an accomplice to murder.|
Accustom|to make familiar by use|I blinked repeatedly, trying to accustom my eyes to the bright light from the sun.|
Acerb|sour, bitter, and sharp in taste|The bitter lemon’s acerb taste caused the toddler to frown.|
Acerbic|expressing harsh or sharp criticism in a clever way|After John heard his teacher’s acerbic comments, he was not motivated to complete his project.|
Ache|continious, but not strong pain|The doctor was able to diagnose Mark’s illness based on the symptom being a sharp pain instead of a small ache in his head.|
Achieve|to successfully get or accomplish|I will achieve my goal through patience and diligence.|
Achievement|a thing done successfully|I consider it an achievement that I learned to control my spending.|
Achromatic|for something to be colorless usually with black, white and grays|Since the house was newly built, it looked like nobody lived in it due to it achromatic walls and stark rooms.|
Acidulous|harsh in manner or flavor|The acidulous drink burned my tongue.|
Acknowledge|to confirm or admit the truth about something|The president will acknowledge the soldiers’ suspicious deaths during his address to the nation.|
Acknowledgment|the act of recognizing or admitting the truth of something|There is great acknowledgment in America that minimum wage levels are too low.|
Acme|the highest peak that is reachable|At her acme, the singer was making over thirty million dollars a year.|
Acoustic|relating to sound or hearing|Enjoying the sound of the acoustic guitar, the crowd nodded along and moved closer to the band.|
Acquaint|to become at ease with|The faculty mixer is the perfect time for you to acquaint yourself with your teachers.|
Acquaintance|a person one knows slightly but not well|Ms. Smith was embarrassed that she didn’t know the name of the acquaintance who recognized her at the store.|
Acquainted|familiar with a specific subject or person|If you are acquainted with the hiring manager, I would love to give him a copy of my resume.|
Acquiesce|to agree or express agreement|While I did not want to go to the show with Laura, her begging eventually caused me to acquiesce.|
Acquiescent|willing to acquiesce, accept or agree to something without objection, protest or resistance|More often than not, he possessed an acquiescent nature, which made it easy to work alongside him in combination with his quick thinking and street smarts.|
Acquire|to obtain something|You will need a great deal of money to acquire the valuable painting.|
Acquisition|the thing acquired or gained; a gain.|Because he was marrying her, there would be an acquisition of all of her real estate.|
Acquisitive|eager and capable of making acquisitions |While I am somewhat acquisitive and can afford to buy anything I want, I try to only purchase things I need.|
Acquittal|a setting free from the charge of an offense or verdict|After the defendant learned of his acquittal, he jumped for joy.|
Acquitted|found innocent of a charge or accusation|Even though the judge believed the defendant was guilty, he could say nothing when the jury acquitted the man of all charges.|
Acrid|bitter and unpleasant in taste or smell|The acrid fumes from the plant made my eyes water.|
Acrimony|a sharp and bitter hatred|Her acrimony for her neighbors manifests itself with shouting and stomping.|
Acrobat|an athlete who performs acts requiring skill, agility and coordination.|The watchers held their breath as the acrobat crossed the tightrope.|
Acronym|a term created out of the first letters of a multi-word phrase|In history class, the students learned the acronym NATO stands for the North Atlantic Treaty Organization.|
Acrophobia|an unusual dread of elevated places|Because I have acrophobia, I never ride anything other than the Ferris wheel at the amusement park.|
Acropolis|a stronghold or sanctuary used for defensive and religious purposes in ancient Grecian cities|In the middle of the city, an acropolis of stone walls was erected to act as a shelter during times of war.|
Across|from one side to another|Swimming across the wide river left the stranded paddler gasping for air.|
Action|combat; battle|The movie was full of action, with most of the scenes containing fighting or warfare.|
Activate|to trigger or start something|If you want to use the new debit card, you have to call a new number and activate it.|
Activism|a strategy of undertaking direct action to achieve a social or political goal|Protesting the war is a type of activism.|
Activist|a person who campaigns for some kind of social change|The political activist spent hours trying to convince us to vote for Ted.|
Activity|something that people do, usually with a particular aim or goal in mind|The teacher brought all of the paper, glue, and other items needed for the students to complete the crafting activity.|
Actual|Real or concrete|Although there is actual proof that they existed, some still don’t believe in dinosaurs.|
Actuality|the state of existing; existence|Although it was thought that no one had been working on the project, in actuality Barbara had been trying to get things of the ground for a long time.|
Actuate|to trigger a movement or action|The teenager touched the screen to actuate the mobile app.|
Acuity|sharpness in relation to thought, vision, or hearing|In order for my daughter to get into the school’s gifted program, she had to take a mental acuity test.|
Acumen|experience or expertise in something|John’s business acumen, along with his computer skills, made him an asset to the software company.|
Acupuncture|a medical practice in which thin needles are inserted into specific points of the body as a way to relieve pain or treat disease|As soon as the acupuncture needles entered the man’s spine, he felt relief from his pain.|
Acute|extremely pressing; critical|Because my appendicitis was an acute issue, the nurse took me directly into an emergency station for treatment.|
Acuteness|sharpness; insight|The boy’s acuteness made him an excellent chess player.|
Adage|old saying that has come to be accepted as truth over time|He gets tired of all the same old sayings, so he is always trying to come up with a new adage.|
Adamant|refusing to be persuaded; cannot change one's mind|Robert, a first year physics student, is adamant in his decision to peruse a career in engineering.|
Adamantine|unyielding; firm and unbreakable|The hero was adamantine and stuck to his values no matter what problem he faced.|
Adapt|get used to something new or change to fit|When James relocates to a different side of the country, he will have to adapt to a new weather pattern.|
Adaptable|able to change|When dogs live in the wild, their bodies must be adaptable to the environment or they will suffer.|
Adaptation|an alteration that makes an animal or thing more suitable for a certain environment|This adaptation of the novel was written so the story could be performed as a play.|
Addend|a number added to another number|I asked our math teacher to help me with the addend in my math problem.|
Addendum|something to be added; especially text added as an appendix or supplement to a document|Maria’s article was written in 1965, but it was updated with an addendum in recent years.|
Addict|someone that is obsessed with something to an extent where they suffer withdrawal without it|My baby brother is a sugar addict, unable to go even two hours without consuming some sort of sweet to sate his obsession.|
Addictive|something that is easy to be addicted to; easy to develop a reliance on|This game is extremely addictive, having roped me into playing it for over six hours even though I only planned to play for one.|
Additional|added or extra|Additional charges will be added if you do not pay the bill on time.|
Additionally|used in the place of ‘also’ or to introduce extra facts|We started out with just one floor, but additionally, another was added.|
Addle|to cause a person’s thoughts to become jumbled or confused|Is it true smoking marijuana can addle your brain and make it difficult for you to concentrate?|
Addled|incapable of thinking in a clear manner|Because my grandmother is in her mid-nineties, she is a bit addled at times and requires the aid of a personal caregiver.|
Address|a description of the location of a property|The pizza delivery man had no problem finding my address to deliver my order.|
Adduce|to produce as support during a discussion or argument|During the trial the defense attorney will adduce evidence to show the defendant’s innocence.|
Adduction|the act of bringing a body part usually an arm or leg inward to the middle part of the body|When the patient’s adduction of her knee up to her waist caused agonizing pain, the doctor recommended that she return to standing straight on her two feet.|
Adept|very good at doing something that is not easy|Mark is an adept juggler who can easily manager four balls in the air without dropping one.|
Adequacy|being satisfactory or acceptable|The adequacy of the program is being questioned since few seem to graduate after starting.|
Adequacy|the quality of being sufficient, adequate or able to meet the needs|It’s important to review the adequacy of your medical insurance coverage each year.|
Adequate|enough; good enough|Adequate water intake is necessary for your body to function properly.|
Adhere|conform to or follow rules exactly|When I tell you to sit down, adhere to my order!|
Adherence|faithful support for a cause |The teacher demanded the students adherence to the rules while in her classroom.|
Adherent|a material that sticks to other things or a person who supports a particular party, person, or set of ideas|The adherent properties of Super Glue are so strong that some people have had to go to the ER to get un-stuck from something.|
Adhesion|a substance’s ability to attach to another substance|For sturdier adhesion, apply hot glue to the sequins prior to attaching them to the leotard.|
Adhesive|sticky|Mom does not like to use Elmer’s glue because she claims that our project requires a stronger adhesive.|
Adieu|a farewell, a goodbye; especially a fond farewell, or a lasting or permanent farewell|We bid each other adieu after the movies by giving one another a hug.|
Adjacent|lying next to, close, or contiguous; neighboring|When the opposing attorneys asked for a sidebar with the judge, the jury was sent to wait in an adjacent area.|
Adjoining|next to or joined with something else|The travelers requested adjoining rooms so that they would be beside each other.|
Adjudge|to view or determine something in a particular manner|Because of your drug problem, the court will probably adjudge you to be an unfit mother.|
Adjunct|something that is joined or added to another thing, but not part of the whole|My math teacher was adjunct faculty and did not work for the school full time.|
Adjure|request or urge someone to do something|I had to adjure myself to stay awake, despite having not slept in two days.|
Adjust|to change something a little so that it fits or works better|The distraught teacher preferred her students to adjust their attitude before she initiated her next plan of referring those students to the office.|
Adjustment|a small change that improves something or makes it work better|The academic advisor made an adjustment to the college student’s classes so that it would fit better with her work schedule.|
Adjutant|A military officer that is an administrative assistant to a senior officer|Lieutenant Tirado is my adjutant, taking care of administrative duties when my position as a Colonel demands my attention.|
Administer|to supply or give out something|The nurse will administer pain medicine every four hours.|
Administer|to give, handout, or dispense|A nurse came into the patient’s hospital room to change his sheets and administer his nightly medication.|
Administration|the process of running some sort of organization|I do not wish to work in administration because I do not like being in charge of other people, though I still have to order around a few people in my work.|
Admirable|worthy of respect and admiration|The colonel is an admirable man who has won numerous medals of valor.|
Admiration|a sentiment of esteem and respect|When the teacher retired, she was given a gold watch in admiration of her fifty years of service to the county.|
Admire|to hold a thing or person in high esteem|As a former soldier, I admire all the men and women who are currently serving in the military.|
Admissible|something that is allowed or considered appropriate|Judge Taylor declared the evidence against the defendant admissible in court which became detrimental to the defense’s case.|
Admit|to acknowledge that something is real, valid, or true|It took the woman a long time to admit she has a drinking problem.|
Admittedly|certainly; definitely|The joke was admittedly risky but the crowd didn’t seem to mind much.|
Admonish|to scold; to warn strongly|Do not admonish him for being gay!|
Admonition|a warning or reprimand given with advice|Gerald’s admonition against the other police officers served as a warning to those doing wrong in the organization.|
Admonitory|conveying a warning|The teacher’s voice had an admonitory tone as she told the students to stop talking or lose recess.|
Ado|trouble, difficulty, or complications|There was a great deal of ado in trying to stop the committee from cancelling the school talent show, but all of the trouble was worth it since we succeeded.|
Adobe|sundried bricks made of clay|The village dwellings were adobe style and were crafted from clay and water.|
Adolescence|the time period when a young person becomes a grownup|When children reach the period of adolescence, they crave freedom to make their own choices.|
Adonis|a very handsome young man|“Look at that Adonis,” the girl giggled to her friend as the handsome new freshman walked into the cafeteria.|
Adopt|a legal process to take care of another’s biological child as your own|Many childless couples will adopt the less fortunate children from around the globe.|
Adoptive|related to someone through adoption (becoming a parent or child of someone not by birth)|The little girl’s adoptive parents gained legal custody of her when she was just two weeks old.|
Adoptive|related through adoption|Because her adoptive parents were so wonderful while raising her, the young woman had no desire to meet the birth family who had given her up.|
Adorable|charming and easy to love because it is so attractively cute|With an adorable smile, the delightful toddler stole the hearts of everyone in the room.|
Adoration|deep love, devotion, and respect|The young man’s adoration for the new girl in class was evident when the teacher called him out for staring at her.|
Adore|to idolize or worship something, or to love it very much|My mother loves to adore me in public even though I find it embarrassing, praising me in front of everyone as if I were still a child.|
Adorn|make more attractive or beautiful|George likes to adorn his office with expensive paintings so that everyone knows how wealthy he is.|
Adornment|an ornament or decoration that adds attractiveness|The plain tree need an adornment, so a silver star was added to the top.|
Adrenaline|a chemical produced by your adrenal glands that gives you a rush of energy when you are frightened, excited, or angry|I had a rush of adrenaline as I jumped out of the airplane.|
Adrift|uncontrolled floating on water |The U.S. Coast Guard located two boats adrift in the ocean after a storm passed through.|
Adroit|clever or skillful|The child was an adroit pianist at an early age.|
Adscititious|additional or external; coming from an outside source|The supplemental information was adscititious and wasn’t a part of the original investigation.|
Adulation|great praise for someone, often more than what is deserved|Although Jason was a famous celebrity, he was very uncomfortable with the adulation from his fans.|
Adulterate|to make a substance less pure by adding something else to it|If you want to adulterate your alcoholic drink, you should add some water to it.|
Adultery|sexual activity between a married person and someone other than their spouse|The attorney’s marriage was ruined by his decision to commit adultery with his secretary.|
Adulthood|the state or condition of being fully grown or mature|In the United States, a child reaches adulthood at the age of 18.|
Adumbrate|to create an outline or a faint shadow |With assistance from the victim, the sketch artist will adumbrate a picture of the robbery suspect.|
Advance|before; ahead of time|The concert goers bought their tickets in advance so they wouldn’t end up with terrible seats.|
Advanced|progressive; complex or of a higher order|Advanced courses are offered for students who want to progress quickly in a subject.|
Advantage|a condition or circumstance that gives someone a greater chance of success|The thief took advantage of the light security on New Year’s Eve to empty every cash register in the mall.|
Advantageous|helpful or useful and likely to make you more successful|It would be advantageous for the couple to buy the bedroom set while it was on sale.|
Advent|the coming or arrival of something|With the advent of the internet, working from home has become a real phenomenon.|
Adventitious|not natural; foreign|The weird-looking plant is adventitious and not native to this country.|
Adventure|an exciting or dangerous experience|Setting off on an adventure, Peter Pan hoped to avoid any pitfalls that would put him in the hand of Captain Hook.|
Adventuresome|adventurous or prone to going on adventures|My adventuresome friend is constantly looking for ways to explore new places, see new things, and meet new people.|
Adventurous|daring; brave|Bold and adventurous, the dare devil was always looking for a new exploit to undertake.|
Adversary|one's opponent in a contest, conflict, or dispute|I will destroy my adversary during our battle.|
Adverse|negative, harmful, or unpleasant|Jim’s adverse reaction to the drug was so intense that we rushed him to the hospital.|
Adversely|in a negative or bad way|If the medicine adversely changes your health, you should stop taking it immediately.|
Adversity|a difficult situation or condition; misfortune|Because of the five-year drought, the farmer experienced a long period of adversity.|
Advert|an advertisement|The newspaper advert announced position openings at the local potato plant.|
Advertise|to provide information about a person or goods and services to influence others |Retail stores advertise their sales products by using the newspaper, radio and television to attract customers into their stores.|
Advice|an opinion recommended or offered, as worthy to be followed; counsel|Beatrice hates to take advice from anyone, which is why she is doomed to fail in everything that she does.|
Advisable|worthy of being recommended; desirable|It is advisable to fill your tank before heading out on a trip so that you do not waste time worrying about where to find the nearest gas station.|
Advise|to offer suggestions to a person or group|Could you please advise me on the best way to get to the interstate?|
Advisement|advice that is both carefully considered and thought out before given|The homeowners association calls meetings for neighborhood members to voice their opinions on important issues that they were record, take under advisement, and use to make decisions for the community in the future.|
Advisory|an official announcement that usually serves as a warning to the public|The city government released an advisory during the hurricane warning all residents not to go outside.|
Advocacy|the practice of supporting someone to make their voice heard |Recently the gun advocacy groups have spoken to Congress with hopes of change to current gun laws.|
Advocate|to publicly support a particular policy or way of doing things|Any good doctor will advocate healthy eating for his patients.|
Aegis|under the influence or protection of a specific individual, body, or government|As a young salesman, Stan worked under the aegis of his father who emphasized the value of treating customers fairly.|
Aerate|to cause air to circulate through something|The cleaners needed to aerate the room to get the strong odor out.|
Aerial|happening in the air|An aerial view of the city showed just how cluttered and crowded the metropolitan area looks from above.|
Aerie|a nest built in a high place by a predatory bird |While hiking in the hills, we spotted a hawk leave it’s aerie on the cliff.|
Aerobic|activity used to strengthen the heart and lungs by making them work hard for several minutes|The aerobic component of the test consists of a strenuous one-mile hike.|
Aerodynamics|the study of air and how it works when an object moves through it|Birds have a natural understanding of aerodynamics that allows them to fly through even the windiest conditions.|
Aeronautics|the science of flight|A Boeing 727 was donated to the college’s aeronautics program for further flight studies.|
Aerosol|substances confined under pressure and typically released in the form of a spray|A well-known form of aerosol is Febreeze, which is a spray that is released from under pressure to eliminate bad odors.|
Aerospace|the atmosphere of the Earth and the region of space around it; the industry concerned with aircraft, missiles, satellites and spacecraft|From the aerospace department of the scientific company, many reports revealed their aviation problems were due to human error.|
Aesthete|one who strongly appreciates beauty, art and music|The aesthete obtained box tickets to the opera.|
Aesthetic|concerning or characterized by an appreciation of beauty or good taste|Our aesthetic enjoyment of the art show was increased by the presence of the open bar.|
Afar|in a distant area|Everyone could tell that the stranger came from afar due to his unknown accent.|
Afebrile|having no fever|Garry worried that his girl was running a fever, but the doctor assured him that she was afebrile.|
Affable|friendly, good-natured, or easy to talk to|Instead of being such a jerk, you should try being more affable!|
Affair|an issue or concern that is handled|Stealing office supplies became a company affair when the company began to lose money due to the theft.|
Affect|to change or influence|If the boy had known skipping class would negatively affect his grades, he would never have missed his lectures.|
Affectation|an unnatural form of behavior that is meant to impress others|Jake’s proper manner of speaking was an affectation he put on when he was surrounded by the country club set.|
Affection|a feeling of love or strong attachment|Rick expressed deep affection for his wife at their fortieth anniversary party.|
Affectionate|loving|My sister is very affectionate and always gives me a goodbye hug.|
Affiliated|formally associated with a group or organization|After being fired, the doctor was no longer affiliated with the hospital.|
Affiliation|the involvement or connection that somebody has with a religious or political organization|The interviewer acted in rude fashion when questioning the candidates about their religious affiliation.|
Affinity|a natural liking or attraction for someone or something|Although Adam is very different than me, I have an affinity for him which I cannot describe.|
Affirm|to publicly verify something|Tonight, the police will affirm the suspect’s identity on national television.|
Affirmation|an action of approval or support|I enjoyed the food critic’s affirmation in his column after he dined in my restaurant.|
Affix|to stick, attach, or fasten|I plan to affix a stamp on every one of the hundreds of envelopes that we need to mail out.|
Afflatus|a skill or gift that seems to be given by a God or higher power|The dancer was struck with afflatus and moved like she was gifted with skills from the gods.|
Afflicted|stricken, distressed, or impaired|The man was afflicted with a painful snake bite after a hike on the mountain.|
Affliction|a state of pain, suffering, distress or agony|Although some people claim that she is lucky because she can’t gain weight, she considers it an affliction.|
Affluence|a situation in which one has a great amount of wealth|When the economy crashed, many people of affluence became poor.|
Affluent|wealthy, rich|Only affluent families could afford the top-dollar price tags attached to the homes in that neighborhood.|
Afford|have enough money to pay for something|The bum claimed he couldn’t pay his bills, but always found a way to afford cigarettes and booze.|
Affray|a disruptive fight|What began as a simple squabble between friends turned into an affray among several people.|
Affright|fright; fear |Ghosts and goblins haunted the house, leaving the children in affright.|
Affront|to do or say something that shows a lack of respect |The crooked cop is an affront to all that is good about law enforcement.|
Aficionado|an expert or enthusiast who is extremely knowledgeable about a subject or activity|A wine tasting aficionado, Lynn is convinced that no one has sampled as many different types of vino as she has.|
Afield|far away from their comfortable environment|While working afield in a foreign country, the young businessman was completely lost as to how to communicate or act in this new place.|
Afloat|floating or balancing on top of liquid|An overturned life raft was able to keep several of the Titanic passengers afloat until help arrived.|
Aforementioned|regarding someone or something spoken about previously|Any of the aforementioned applicants will make great company employees.|
Aforesaid|previously mentioned|After pleading my case to my mom, I went to my dad and repeated the aforesaid points in hopes that he would let me go to the mall.|
Afraid|scared or frightened|The toddler is afraid of the dark and will not sleep without a nightlight.|
Aftermath|the aftereffects or consequences of an unpleasant or destructive event|More frightening than the hurricane was the aftermath and incomprehensible task of rebuilding.|
Afterthought|something you think of or mention later because it was not included beforehand|Often considered as an afterthought, Nick realized that he was not valued by the basketball team.|
Afterwards|following; after a previous event|I will take you to the park, but afterwards we must clean the house.|
Against|anti; not in favor of|Many people were against the war and didn’t think we should be fighting overseas.|
Agape|open|Before you eat oysters, clams, or mussels, always check to be sure that the shells are firmly closed and not even a little bit agape.|
Age|the amount of time someone or something has been living|The youthful woman’s age was actually much older it appeared to be.|
Agency|a business, usually government related, that provides a particular service|As head of the agency, the top-manager was in charge of all spending decisions.|
Agenda|a list of matters to be discussed at a meeting|Without a clear agenda for what is to be accomplished I feel that the meeting will be a waste of time.|
Agent|a person who acts on behalf of an individual or some other group|My insurance agent sold me a new life insurance policy through the company he works for.|
Agglomeration|a collection or mass of things|The mayor has an agglomeration of complaints against him, which is why he may not be in office much longer.|
Aggrandize|make great or greater in power, rank, honor, or wealth; increase|I attempted to aggrandize the CEO’s high status in the company to sweet talk him into signing off on the deal.|
Aggrandizement|an increase in power, importance, or reputation that is undeserved|Suzan suggests that aggrandizement of one’s self-worth may be a desperate attempt to boost one’s low self-esteem.|
Aggravate|to make worse, or more severe|I left the party early so the noise would not aggravate my headache.|
Aggregate|to place into a category or cluster|Schools often use test scores to aggregate students into classes based on intelligence.|
Aggregator|someone or something that gathers together materials from a variety of sources and combines them into one|The aggregator was able to gather articles from many different websites and condense them into one publication.|
Aggression|violent and hostile behavior|Seething with aggression, the deranged man was shot after he lunged at police with a knife.|
Aggressive|pushy or forceful when trying to get others to believe or do something|The aggressive vendor tried to force the tourists into buying his wares.|
Aggressor|the person or country that first attacks or makes an aggression|Once the two kids were separated, it became obvious who the aggressor was due to his explanation about how he hit first.|
Aggrieve|to badly mistreat/make upset|If the boy insults my mother and continues to tease and taunt me, he would prove he knows how to aggrieve me.|
Aggrieved|angry or resentful due to unjust treatment|Parking almost fifteen feet from the corner, the aggrieved driver tore up the ticket he received for parking too close to the intersection.|
Aghast|shocked or surprised in an upsetting way|The teacher was aghast at the large number of students who failed the easy test.|
Agile|able to move fast and easily|Because he practiced parkour, he was an extremely agile athlete.|
Agility|nimbleness and quickness of motion, both physically and figuratively|The coach was amazed at Jim’s agility on the court, especially the way he switches direction without pause.|
Agitate|to disturb or upset|Barking at the dog will only agitate him further.|
Agitated|upset; disturbed|Barbara felt agitated when her husband did not pick up his phone, especially since she had been calling all day.|
Agitation|a stirring up or arousing; disturbance of tranquility |The father of one made no attempt to hide his agitation while viewing his son’s failing report card.|
Agitprop|something that looks like art but is actually political propaganda or misinformation|Many documentaries come across as entertainment but this one is a political agitprop that is being used to deceive people.|
Agnostic|unsure about the existence of a god or holy being|After my husband became agnostic, he stopped going to church because of his doubt about god's existence.|
Agnostic|someone who believes there is no way to know if God does or does not exist|As an agnostic, Devin questioned whether there is any proof that a God created the universe.|
Agnostic|a person who knows there is no way to know if God exists or not|The agnostic woman has read the Bible and other religious texts but still doesn’t think there is a way to prove that God exists.|
Agog|filled with anticipation and excitement|The little kids were agog as they waited for Santa Claus to arrive.|
Agonize|to endure a great deal of distress|After resigning from my job, I started to agonize over my decision.|
Agonizing|distressing; painful|The pain of breaking my femur was agonizing.|
Agony|intense pain or suffering|When my brother died, I was in emotional agony for months.|
Agoraphobia|the fear of wide open spaces, crowds, or uncontrolled social conditions|Even the big deals on Black Friday could bring out even those people who suffer from agoraphobia, but the large groups of people could cause them to have anxiety attacks.|
Agrarian|associated with land cultivation|An agrarian college prepares men and women for careers in land cultivation.|
Agree|to say yes or give consent|My father wishes I would agree to move back home, but I enjoy living by myself.|
Agreeable|nice and good; pleasant|After considerable negotiations, both parties became agreeable by each side giving in to some part of the situation.|
Agreement|a contract or deal|By signing an agreement with the lawyer, the client agreed to pay two thousand dollars for his services.|
Agribusiness|any business that has to do with agriculture and supplies associated with farming|John Deere is a well known agribusiness that supplies many farms with bright green tractors.|
Agriculture|the discipline of farming|The state manages a department of agriculture which provides support to farmers.|
Agronomy|science of soil management and crop production|Personally I find agronomy to be a rather boring science, but someone has to study all the ways we can make crop production more efficient.|
Ague|a fever that causes you to shake, sweat and feel cold|Dr. Frank determined that his patient acquired ague based on the symptoms but, he realized it was not malaria because the patient had not visited tropical areas lately.|
Ahead|to move forward from current placement|The determined student tried to get ahead on her homework by completing her project two weeks in advance.|
Ahem|an utterance similar to the sound of clearing one's throat, used to attract attention or fill in a pause|“Ahem,” the man breathed nervously as he cleared his throat.|
Aid|to back or help someone or something so they are successful|Red Cross workers usually aid in the recovery of victims of natural disasters by providing medical care to those who are injured.|
Ail|a trouble, symptom, or affliction|A common ail that afflicts people when they have a cold is a runny nose, but that is just one of the sinus issues that come along with that.|
Ailment|a condition that affects a person’s mental or physical wellbeing|Unfortunately, the stomach ailment causes vomiting and chronic diarrhea.|
Ailurophile|a person who loves cats|The neighborhood children only saw the ailurophile as a nutty cat lady.|
Aim|to point something in a certain direction|The hunter began to aim his bow at the deer as soon as it came out of the clearing.|
Aimlessly|without an aim, purpose or direction|I love to spend my weekends wandering aimlessly through the streets of Manhattan, checking out stores and shops that pique my interest.|
Air|the invisible mixture of gases that covers the earth|A tasty odor in the air seemed to float through around the kitchen.|
Aisle|a clear path between rows of seating|The bus ride home was so packed that anyone without a seat was forced to sit in the center aisle.|
Ajar|slightly opened|She left her bedroom door ajar, so I figured it was safe to enter.|
Akimbo|with the hand on the hip and elbow turned outward|Mom looked at the mess in my room, arms akimbo, and began yelling at the top of her lungs.|
Akin|similar in nature|For Elizabeth, divorcing her ninth husband was akin to throwing out old shoes and buying a new pair.|
Alabaster|a smooth, white, and often translucent hard material that is typically carved|Her smooth, white skin resembled alabaster sculptures.|
Alacritous|being eager and willing|The alacritous recruit was ready to join the Army and signed up the day he turned eighteen.|
Alacrity|Cheerful willingness and eagerness|Having studied really hard last night, the student took the exam with alacrity.|
Alas|disappointingly; unfortunately|Alas the reviews for Jared’s book were awful, and as such, the book’s sales were dismal.|
Albatross|a species of large seafaring bird that is found mostly in the south Pacific|An albatross has a significantly larger wingspan than a seagull, but personally I think they’re nearly the same bird.|
Albeit|even though; although|I am a huge fan of Madonna’s music, albeit I do not own any of her albums.|
Albinism|an inherited condition that one is born with that involves lack of color in the pigment that colors hair, skin, and eyes|The couple’s baby was born with albinism and had hair that was as white as snow.|
Alchemist|a person who practiced a medieval form of chemistry that dealt with metal transformations|The medieval alchemist spent most of his days trying to change metal to gold.|
Alchemy|a kind of chemistry that is associated with changing something ordinary into something extraordinary|In the story the fairy godmother used alchemy to turn the pumpkin into a fine carriage.|
Alcove|a small area that is secluded from a large space|The alcove above the living room is the perfect place for the kids to hang out and play videogames.|
Aleatory|random, dependent on luck or chance|Rick laughs at anyone who spends money at the slot machines, because it’s a purely aleatory game that has no intellectual component whatsoever.|
Alert|to strongly make someone or something aware of trouble or something dangerous that is about to occur|Sheriff Taylor needed to alert the citizens of his small town about the approaching large hurricane close to them.|
Alfresco|outdoors, open to the atmosphere|The park has a really nice restaurant where you can dine alfresco while watching the birds as they come pecking at your food.|
Algae|an organism often found on or in bodies of water that resembles a plant or moss and uses photosynthesis to supply oxygen|A thin layer of green algae lined the bottom of the dirty swimming pool.|
Algorithm|set of instructions|Many scientists were required to solve and describe the algorithm for each problem they solved in order to be accepted to the company.|
Alias|an alternate name used by a person who wishes to keep his or her identity secret|If you’re having a hard time locating Sarah’s blog, try searching for it under her alias, Hannah Martin.|
Alibi|a reason or excuse why someone could not have done something|While the witness claims the suspect was at the murder scene, the suspect’s alibi places him in another state.|
Alien|different from the norm or what is considered to be acceptable|Everyone in the room disbelieved the man’s story about being abducted by an alien from another planet.|
Alienate|to make an individual feel unwanted or removed from a group or relationship |Teachers will alienate their students if they talk down to them.|
Alight|to descend from something |The birds will alight from the sky and then eat from the feeder.|
Align|line up; straighten|Every afternoon, the teacher has to align the desks that her students have pushed out of place.|
Alignment|positioning of things so that they are in a straight line|The chiropractor was able to bring the woman’s discs into alignment so that her back would be straight.|
Alike|similar in a certain way|Because my sister and I are identical twins, we are very much alike in appearance.|
Aliment|a minor illness or sickness|The boy faked an aliment so that he could stay home and not go to school.|
Alimentary|of, or relating to food, nutrition or digestion|The esophagus is considered part of the alimentary canal because it is one of the passageways for food.|
Alimony|payment paid to one’s former spouse to support their living|Alimony payments were made from the wealthy ex-husband to his bitter ex-wife.|
Alive|living, not dead|The possum played like he was dead, but he was really alive.|
All-around|versatile; able to do many things|Aaron is an all-around athlete who shines in many different sporting events.|
Allay|to make quiet or calm|A good teacher will work hard to allay the concerns of a new student.|
Allegation|a claim or a statement saying someone has done something illegal or wrong, which is not necessarily based on facts|The professor made an allegation of cheating against his student.|
Allege|to claim without evidence|In the lawsuit, the parents allege the school system failed to protect their daughter from bullies.|
Alleged|questionable; not confirmed|While the alleged suspect was arrested today, he still has to be tried in a court of law.|
Allegedly|suspected of participating in something immoral or illegal |According to the witness, the mailman allegedly broke into the woman’s car.|
Allegiance|loyalty to some cause, nation or ruler|Standing opposite the flag, I placed my right hand on my heart to recite the pledge of allegiance.|
Allele|an alternative pattern of a gene that results in a variation of a trait|The dominant allele is the one that determines a physical characteristic or trait.|
Alleviate|to make something less painful, severe, or serious|Take an aspirin to alleviate your headache.|
Alley|a narrow passageway|Walking through the dark alley, Giana thought the passageway seemed to be filled with scary sights at every turn.|
Alliance|an association between parties or states with similar interests|We formed a neighborhood alliance to plan events in our community.|
Allies|friends or supporters; those who can be trusted|The USSR and Russia were allies in World War II, but their friendship turned to mistrust soon after the conflict ended.|
Alliteration|the recurrence of consonants at the start of two or more terms |In poetry, alliteration is sometimes used to create a unique tone by repeating consonant sounds.|
Allocate|to give out according to a system|I must allocate my weekly salary in a way that allows me to pay all my bills.|
Allocation|an amount of something that is given out or shared|Inconsistency in allocation of funds led to a negative balance in one account.|
Allocution|a speech given to a convicted defendant by the judge just prior to sentencing|During the allocution, the convicted party refused to listen to the judge as she spoke.|
Allotment|one share of something that has been given out in portions|Staring at the plates on the tables, the bride was happy to see the caterer had given each guest a large allotment of shrimp.|
Allow|to permit or let something happen|Please allow five days for the package to get from the store to your home.|
Allowance|a share or portion of something that is granted by another person|Timmy is given an allowance of his mother’s income, but is expected to do well in school and finish his chores.|
Allowed|permitted or let something happen|Lola’s mom allowed her to spend the night at my house last weekend but wouldn’t let her come over today.|
Allowed|let or permitted someone to do something|The professor allowed her son to turn his essay in one day late but took points off.|
Alloy|a mixed metal made by combining two or more others that is usually stronger than pure metals|Alloy wheels are made from a mixture of other metals, making them tougher.|
Allude|to make an indirect reference|The teacher asked the students to not allude to any online sources in their research papers.|
Allure|a quality that produces attraction|The woman’s allure was her floral perfume that captivated the man’s senses.|
Allusion|a statement that refers to something indirectly; an indirect reference|The author’s new book contains an allusion to mythological gods.|
Allusion|a figure of speech that is used in literature to make an indirect reference to something|The author included an allusion in her speech when she referred to Romeo but didn’t explain who he was.|
Allusive|implying, hinting or indirectly suggesting something|The man was very allusive when he dropped hints about the gifts he bought for his wife’s birthday.|
Alluvial|related to alluvium, a deposit of clay, silt, and gravel left by a flowing river in a delta|The sediment around this river delta is alluvial, full of silt and clay that will make the soil extremely fertile.|
Ally|a friend; someone who is ready to help you|When my friends were arguing, Carly was my ally and defended my actions.|
Almanac|an annual calendar with important events and astronomical data|An almanac is not really different from most other calendars, but it also has a great deal of other information in it, like astronomical data needed for farming.|
Almighty|omnipotent or having complete power|The men seemed to worship the almighty dollar and cared little about anything else.|
Almost|very nearly but not exactly or entirely|The bandits almost made it to their get-away van, but the police caught them just in time.|
Alms|items which are given to the needy|If not for the alms given to him by charitable groups, the man would have died of hunger.|
Aloft|in the air or sky|When the hot air balloon was aloft, they could see everything on the horizon.|
Alone|having no one else present; on one's own|She loved being alone where no one could bother her and she could relax with a good book.|
Along|beside or by-the-side of something else|The road along the river was recently closed due to flooding.|
Alongside|along the side; by the side; side by side with|The students walked alongside each other on the way to school.|
Aloof|removed or distant either physically or emotionally|The aloof princess stood in a corner alone.|
Alpine|part of a high mountain|In the alpine village, many skiers would purchase their needed supplies in order to go skiing the next day.|
Already|at present; even now|The banker couldn’t attend the board meeting since he was already in a loan hearing across town.|
Alter|to change in some way|The Photoshop expert can alter the picture to make people think you spent your vacation on the beach.|
Alteration|the condition of being changed|Since I have gained weight, I’ll need a seamstress to make an alteration to my wedding dress.|
Altercation|a loud and heated disagreement |The best friends had an altercation over a girl they both liked.|
Alternate|when one thing comes after another; fluctuate|Instead of choosing one pain reliever, Judy decided to alternate between Aspirin and Tylenol.|
Alternative|alternative means another possibility that is available|As an alternative to expulsion, the mischievous student opted to attend in-school suspension.|
Altimeter|an instrument used in an aircraft to measure altitude/the distance above sea or land|An aneroid barometer is an altimeter that is used to detect drops in atmospheric pressure inside an airplane.|
Altitude|the height of something above sea level or the earth's surface|The pilots began shifting gears in order to gain altitude.|
Altitudinous|being at or having a very high level of elevation|Because they are so high up the mountain, the altitudinous villages can only be reached by helicopter.|
Altruist|regard for others without regard for oneself; devotion|He was an altruist, and he loved others better than himself.|
Altruistic|sincerely concerned about the well being of others|The billionaire is an altruistic man who gives away millions of dollars every year to various charities.|
Alum|a chemical substance containing aluminum used in dye things or to make the skin tighter|The chemist explained that alum is a compound often used as an astringent to tighten the skin and remove pimples.|
Alumna|a female graduate of a school or university|The Lake County High School alumna missed her high school days and wished she could relive them.|
Alumnus|an individual who graduated from or took classes at a specific university, school, or college |As part of his last will and testament, the wealthy alumnus left his fortune to the university from which he graduated.|
Alveoli|sacs in the lungs which gather and filter oxygen|The alveoli in the smoker’s lungs were so coated in tar from years of cigarettes that they barely output air.|
Amalgam|a mixture of unlike items|The potluck supper at the church always consists of an amalgam of foods ranging from apricot salad to zucchini casserole.|
Amalgamate|to join or combine|The two companies will amalgamate in a mutually beneficial merger next week.|
Amalgamation|the process of combining two or more companies |The amalgamation process is sometimes decided upon to avoid bankruptcy.|
Amanuensis|a secretary whose job is to write or type what someone else is saying|Her Majesty’s amanuensis quickly wrote down all of her extravagant demands.|
Amass|to bring together a large amount|To start a business, one needs to amass a huge sum of ready money.|
Amateur|person who engages in a particular activity without pursuing it professionally|Even though I am an amateur singer, I hope to make a career out of it one day.|
Amatory|associated with expressing erotic or sexual love|The amatory letters described the couple’s steamy love affair.|
Amaze|to fill with surprise, astonish|Arthur does not fail to amaze everyone with his quick wit and humor.|
Amazed|shocked; stunned|Amazed by the great temple, the tourist stood in awe of the beautiful building.|
Amazement|the condition of being surprised or overcome by wonder |As my boyfriend told me about his plans to propose to another woman, I stared at him in amazement.|
Amazing|impressive; incredible|Looking up at the amazing pyramid, it was hard for Frank to imagine building something so impressive.|
Amber|a yellowy-tan color |The dentist noticed the amber color of the woman’s teeth and realized that she probably hadn’t brushed them in a long time.|
Ambiance|the mood in a place|The scented ambiance of the candle shop made me feel warm and comfortable.|
Ambidextrous|having equal ability in both hands; in particular, able to write equally well with both hands|The team manager was very excited when he heard that the new pitcher was ambidextrous and could throw a mean fastball with either hand.|
Ambiguity|something that does not have a clear meaning|Although Hank wants to sign the contract, he needs to understand the ambiguity of some of the language first.|
Ambiguous|confusing; difficult to understand|Because his driving directions are ambiguous, I use my reliable map.|
Ambition|a desire to accomplish (complete) a task|Despite his old age, Frank has a very strong ambition to climb Mount Everest.|
Ambitious|strongly desirous and determined to succeed|The professor has an easy time controlling his class because the students are ambitious about their studies.|
Ambivalence|mixed feelings or emotions|Even though the new job meant more money, Tad felt a great deal of ambivalence about accepting the position.|
Ambivalent|uncertain as to which path to take|When it comes to the election, I am ambivalent about the candidates.|
Amble|to stroll in a relaxed manner|Since we arrived too early to check into the hotel, we decided to amble down the beach.|
Ambrosial|appealing to one’s sense of smell or taste |Because Janice liked the ambrosial scent of the shrubs, she decided to plant a few in her front yard.|
Ambuscade|a deadly strike|At first the plane’s passengers sat quietly until the hijackers led an ambuscade against the plane’s crew.|
Ambush|the act of concealing oneself and lying in wait to attack by surprise|A suicide bomber waited in ambush for the right opportunity to detonate his bomb, but was tackled before he had the opportunity.|
Ameliorate|to make better|Scratching your eye will not ameliorate the itching.|
Ameliorate|to make something better or more manageable|The police tried to ameliorate the situation after the false arrest, but the family didn’t want to hear their apologies.|
Amenable|willing to comply or cooperate|My husband never complains about anything and is amenable to all my vacation suggestions.|
Amend|to make better|Chris said that he would amend the bill before the year’s end due to the public outcry.|
Amendment|a change or alteration|An amendment was made to the original divorce decree because the wife’s name was spelled wrong.|
Amends|to fix a mistake that you made or to make a bad situation better; to make right|In an effort to make amends with his girlfriend after cancelling their dinner, he brought her a dozen roses.|
Amenity|a thing or condition that makes an event or life more enjoyable|The walk-in closet was my favorite amenity in the apartment.|
Amiable|being nice; displaying a friendly and pleasant manner|Because she was nice to all her fellow students, my cousin Sally was voted the most amiable female at her school.|
Amicable|showing a polite and friendly desire to avoid disagreement and argument|If you were a bit more amicable, people would not be afraid to approach you.|
Amid|in the middle of; surrounded by|Amid a crowd of cheering fans, Larry stood out as the one person who was clearly uninterested in the game.|
Amidst|in the middle or mist of|As I gazed out the back of the car, I saw a lone deer standing amidst the trees on the side of the road.|
Amiss|improper; wrong|When I saw the lights on in the house after midnight, I knew something was amiss because my grandmother always went to bed early.|
Amity|a supportive relationship between people or countries|Because of the amity in our subdivision, everyone looks out for each other.|
Amnesia|loss of memory; forgetfulness|Bob sustained brain damage from the fall, which caused amnesia to set in.|
Amnesty|a formal pardon or reprieve given to one who has committed a criminal or political offense |Although Bill Smith was sentenced to life in prison in 1998, he was later released after receiving amnesty from the president.|
Amoeba|a single-celled animal which catches food and moves about by extending finger-like projections|The amoeba can only be used through a microscope since it is such a tiny animal.|
Amok|a desire or passion to attack or murder|Terrorists fighting amok in the Middle East was disturbing enough until they would cause the death of people near the city where I lived.|
Amongst|surrounded by; In the company of|Amongst the bushes, a small rabbit hid from the hunter.|
Amorous|having or showing strong feelings of sexual attraction or love|The amorous couple could not stop kissing in public.|
Amorphous|having no clear shape or form|Because the painting was amorphous, I had no idea what it represented.|
Amortization|the process of determining the cost of something intangible over time|You can try to use amortization to determine the value of something unseen, such as friendship or memories, but ultimately that might still be impossible.|
Amortize|to the amount of a loan or debt by paying small payments over time|The businessman was able to amortize his building loan by paying monthly payments on the first and the 15th.|
Amount|the total number or quantity|A large amount of ducks in the area will leave here and fly south for the winter.|
Amour|a secret lover|Kissing his amour goodbye, the lovesick man could not bear to part from .|
Amphibious|capable of functioning on land or in water|Frogs are amphibious creatures because they can survive in both land and water.|
Amphitheater|an open-air theatre used for entertainment, performances, and sports|Tickets to the concert were less expensive since the venue was an outdoor amphitheater.|
Amplify|to render larger, more extended, or more intense|We were fine with booking the large ballroom because we knew that the loudspeakers would amplify the sound adequately.|
Amplitude|the measure of something's size, especially in terms of width or breadth; largeness, magnitude|The amplitude of the student’s knowledge about astronomy and physics was beyond the teacher’s grasp.|
