Dirge|a sorrowful literary or musical composition that is used to honor a deceased person |When Kim sang a dirge for her deceased father, she brought everyone to tears.|
Dirigible|something that is capable of being steered or directed|All cars are dirigible in nature, capable of being steered or otherwise controlled by the driver.|
Disabuse|to make aware of the truth|If you wish to continue to believe that falsehood, I will not disabuse you by telling you the truth.|
Disadvantage|a drawback or obstacle|One disadvantage of going to the beach on the holiday weekend is that the shores will be jam-packed with people.|
Disaffected|rebellious and resentful, especially against authority|The disaffected rebels rioted in the streets after the latest police involved killing.|
Disagree|to hold or express a different opinion|Kim and Emma disagree about which movie they should see, so they may go bowling instead.|
Disagreeable|not nice, pleasant, or enjoyable in nature|Mark is an overly disagreeable man, often patronizing others and just outright antagonizing the people he doesn’t like.|
Disagreement|an argument caused by people having differences of opinion|A heated disagreement between the two friends caused them to stop speaking.|
Disallow|to revoke or take away a privilege that was previously allowed|Many parents disallow their children to participate in their favorite activities or hang out with their friends when they’re grounded.|
Disambiguate|to show the differences between two or more meanings clearly|Punctuation in a sentence helps one disambiguate the meaning of each phrase.|
Disappear|to vanish; to cease to be visible|With a blink of an eye, the magician was able to make the rabbit disappear from his hat.|
Disappointed|saddened and upset because of a letdown|The police disappointed that no witnesses came forward to talk to them about the crime.|
Disappointment|a feeling of unhappiness that occurs after something hoped for didn’t go as planned|After she didn’t make the cheerleading team, Tatiana was filled with a feeling of disappointment.|
Disapprobation|a demonstration of disapproval|I lied about my failing grades because I did not want to experience my parents’ disapprobation.|
Disapprove|to reject or refuse something|When Sarah’s boyfriend came in to meet her parents, she knew they would instantly disapprove of him due to his many tattoos, obnoxious attitude and unemployment status.|
Disarmament|taking up or giving away military weapons|The security council demanded full disarmament and that the group give up their weapons within twenty-four hours.|
Disarming|having the ability to decrease suspicions and fears|Because Danny is a disarming man and can easily reduce buyer fears, he is a great car salesman.|
Disaster|an event that causes great damage or hardship|The bride’s rainy wedding day was a disaster that started with missing rings and ended with a run-away groom.|
Disastrous|catastrophic; devastating|The disastrous date ended with the woman running to the bathroom in tears and the man skipping out on the check.|
Disavow|refuse to own; reject|When news of the band’s breakup surfaced, the manager had to disavow any part in the undoing.|
Disband|to separate or disperse permanently|When the Musketeers did disband, there was very little safety in France because the men could only be productive as a group.|
Disbelieve|to refuse or reject the belief or credence of something|The proof provided by the research made it hard to disbelieve in climate change.|
Disburse|to pay out, expend; usually from a public fund or treasury|The federal government said it was studying whether to disburse more relief funds to the state after the damage appears to be severe.|
Discard|to throw something away because it is considered not valuable or needed|Since I decided to discard all of my previous emails, I did not have the evidence stating that I loaned the woman money due to her admission in a June email.|
Discern|to be able to see, recognize, understand, or decide something|It was not difficult to discern that Ellen killed her husband for the million dollar life insurance policy.|
Discernible|noticeable|High gas prices are expected to have a discernible effect on the number of road trips taken this summer.|
Discernment|smart judgement|My grandmother says she has the gift of discernment which helps her when she meets people for the first time.|
Discharge|to dismiss or terminate|When the teenager was caught yelling at a customer, his boss decided to discharge the teenager’s employment.|
Disciple|a student or follower of a teacher or philosopher|After seeing his resurrection, the disciple of Christ set out to spread his message throughout the land.|
Disciplinarian|a person who lives and governs by rules and strictly enforces them|Her former military father was such a disciplinarian that he made everyone in the house wake up at 0500 and run three miles.|
Disciplinary|concerned with making sure rules are followed and not broken|Disciplinary action was taken by the principal after the student refused to listen to the teacher.|
Discipline|a learned behavior that enables the individual to have control over their actions|Habitual runners have such strong discipline that they wake up everyday for their jog even when they're sick or vacationing.|
Disclaim|to deny, as a claim; to refuse|We cannot, in conscience, ignore these facts or disclaim responsibility after Steven found additional information.|
Disclaimer|a statement that rejects responsibility|Prescription drug commercials are mandated to issue a disclaimer, describing the drug's side effects.|
Disclose|to reveal information; disclose|During the interview, the would-be informant agreed to disclose what he knew about the crime.|
Disclosure|the act of revealing something; making known|There is urgency in the plaintiff gaining full disclosure of all relevant documents.|
Discolor|to change or lose color|Washing light laundry with dark may cause your clothes to discolor, completely ruining them.|
Discombobulated|in a confused or bewildered condition |I felt discombobulated after working twelve hours a day for seven straight days.|
Discomfit|to make a person feel uncomfortable|The manager’s mean look served to discomfit me during the interview.|
Discomfiture|a feeling of embarrassment or discomfort|After he lost the election to his rival, a sense of discomfiture crept over the now embarrassed politician.|
Discomfort|being bothered by something to the point that it causes pain or embarrassment|Whenever Brielle caught her parents kissing she was filled with discomfort and quickly ran from the room.|
Disconcert|to upset, frustrate, or embarrass|John would disconcert his parents by not coming home after school.|
Disconcerting|tending to cause discomfort, uneasiness or alarm; unsettling; troubling; upsetting.|I found it very disconcerting to be in the wedding of my former boyfriend.|
Disconnect|break in an existing connection|To be sure electrical appliances and devices won’t be damaged during an lightning storm, everyone should turn off then disconnect the power plugs.|
Disconsolate|sad beyond comforting; inconsolable|The little girl was so disconsolate after her puppy ran away that her parents put up posters all over the neighborhood.|
Discontent|unhappiness, not being at peace with a situation or circumstance|Because of the increase in police related shootings, unhappiness and discontent spread through the city.|
Discontinue|to stop doing or making something|Nike decided to discontinue the new brand of shoes when sales didn’t reach expected levels.|
Discord|tension or strife resulting from a lack of agreement|Knowing that discord is destructive in the classroom, the teacher wanted to foster a sense of community among her students.|
Discordant|harsh or unpleasant in sound|Without proper guidance, the band produces discordant music that no one wants to hear.|
Discount|a reduction of the usually price of an object or service|The winter clothing is being offered with a discount since it now summertime.|
Discouraged|having lost confidence or hope|The two dogs became discouraged from the dog biscuit rolling under the couch.|
Discourse|written or spoken communication or debate|The discourse between the two candidates has not been friendly.|
Discourteous|rude; impolite|Although she considers herself a straight-shooter, my aunt’s blunt tone often comes across as rude and discourteous.|
Discovery|the finding, locating, or uncovering of something|The discovery of gold led many people to travel to Texas by wagon.|
Discredit|to harm the good reputation|The way Leonard responded to the customer was a discredit to the company’s service policy.|
Discreet|not attracting attention; being careful about what one says or does to avoid embarrassing or upsetting others|Hoping to avoid detection, the shoplifter tried to be discreet while walking through the store.|
Discrepancy|a difference or inconsistency especially between things that should be the same|A discrepancy in the financial reports is the reason for the audit.|
Discrete|separate; distinct; individual|Brown and white rice are two discrete varieties.|
Dispassionate|not being affected by or showing feelings |The dispassionate father watched television while his son cried on the floor.|
Dispatch|to quickly send off an individual or thing|According to the terms of the app, the computer will dispatch a vehicle to collect us within thirty seconds.|
Dispel|to cause to depart or be broken apart|The flowers from my husband do not dispel the fact I believe he is cheating on me.|
Dispensation|immunity from a law or rule |In our church, women who have abortions are not given a dispensation of forgiveness.|
Dispense|distribute, or give out|Every pharmacist must accurately dispense the medicine into the proper containers in order for no one to get sick.|
Disperse|to spread out|As soon as the last bell rings, students disperse out of the building and head to their buses.|
Dispirited|having lost all hope; disheartened|After losing the final game of the season, the once excited team was now sad and dispirited.|
Displace|to forcibly move people from their homeland, or to move someone or something|The destructive fire would displace many people from their homes.|
Display|to actively exhibit something much like in a museum|Museums display artwork from hundreds of years ago.|
Displease|to dissatisfy or annoy someone|The new anti-racism laws are sure to displease all the racists in this country.|
Displeasure|feeling of being displeased or annoyed with someone or something|The irate couple got up to leave in disgust, and the woman barked her displeasure at the waiter.|
Disposable|easily expendable and then throw away|Because you can't bring shaving equipment on a plane, many travelers buy disposable razors for the duration of their trip.|
Dispose|to toss out or give to another individual|I need to dispose of the broken blender and buy a new one.|
Disposition|the way that someone normally thinks and behaves |Even though the old man appeared grumpy, he really had a pleasant disposition.|
Dispossess|to deprive someone of the possession of land, especially by evicting them|Once the real estate investor neglected to pay his property taxes, the government took action to dispossess his land.|
Disproportionate|not in proportion; unfair in size|With a disproportionate number of students and staff, the small school scrambled to fit everyone in a classroom.|
Disprove|to prove that something is not true|Many brilliant scientists in the past had to work to disprove the widely held notions of the public in their lifetimes, such as the shape of the world or what the universe revolves around.|
Disputation|a quarrel or disagreement|In order to avoid a disputation about money, Amy handed her credit card to her husband.|
Disputatious|taking pleasure in arguments|Because Ashley is a disputatious person, she is a huge asset to the debate team.|
Dispute|to contest or argue about something|When I saw unauthorized charges on my credit card, I called the bank to dispute the amounts.|
Disqualify|to make someone ineligible for something (such as a prize) because of an offense|When they found the runner had used illegal drugs, the committee members decided to disqualify him from the race.|
Disquiet|a feeling of worry and anxiety|The novel is a tense thriller that will disquiet the reader.|
Disquietude|a condition of worry or concern|The little boy listened in disquietude as his parents argued in the kitchen.|
Disquisition|a long or elaborate essay or discussion on a particular subject|The history student's disquisition was a forty page long manifesto about the benefits of communism.|
Disregard|to ignore or dismiss something|If you disregard the red light at an intersection and keep driving you are not only breaking the law but also endangering your life.|
Disreputable|not worthy of respect|The mob associates decided to kill the disreputable informant.|
Disrepute|the status of being untrustworthy or dishonorable|Once the college fell into disrepute because of the hazing scandal, its number of applicants declined.|
Disrespect|to show a lack of respect to someone or something|This bill shows the government's disrespect for basic human rights and established legal principles.|
Disrupt|to interrupt something by causing a problem or disturbance|The jealous younger sibling attempted to disrupt his brother’s birthday party by throwing a tantrum to place the attention on him instead.|
Dissatisfaction|a state or feeling in which one is not happy or content|The public’s dissatisfaction continued to governor sunk the state’s economy.|
Dissatisfied|not happy or content|Dissatisfied with the restaurant service, the man asked the terrible waitress if he could speak to her manager.|
Dissect|to cut open and examine|Cutting into it with a knife, the biologist began to dissect the animal to look for disease.|
Dissemble|to disguise or conceal behind a false appearance|Her plan was to dissemble her intentions from her husband so she could successfully plan him a surprise party.|
Disseminate|to scatter or spread widely|With encyclopedias in every classroom, we will disseminate a wealth of information to all students.|
Dissension|a disagreement that leads to arguing and discord|Dissension was growing between the two political parties as more scandals came out through the media.|
Dissent|to differ in opinion|More than likely, my father will dissent with the idea I am old enough to set my own curfew.|
Dissentient|opposing the majority|Dissentient voices opposed all of those in congress that supported the bill.|
Disservice|an ill turn or injury|She has done a great disservice to her cause by suggesting that violence is justifiable.|
Dissident|a person who opposes the current political structure, group or laws; one who disagrees|Charlie’s family members were devout Catholics, while he was considered dissident for not identifying with the religion.|
Dissimilar|not alike; having nothing in common|Although they have the same parents, the brother and sister are dissimilar in look and personality.|
Dissimulation|the action of covering the truth|Many anti-government groups believe the president is always conducting acts of dissimulation to deceive the public.|
Dissipate|to drive away|According to meteorologists, the storm will dissipate after a few hours and make way for the sunshine.|
Dissociate|to distance or detach someone or something from a group|When Beverly’s friends started to get into trouble with drugs and alcohol, she decided to dissociate from them and find nicer friends.|
Dissolute|given to immoral behavior |My cousin is a dissolute woman who likes to irritate her religious parents by performing immoral deeds.|
Dissolve|to liquefy; melt into a fluid|Sugar will dissolve quickly in a hot cup of coffee.|
Dissonance|a lack of agreement; generally between what one believes and how one acts|His cruel abuse showed a dissonance with his loving words.|
Dissuade|to convince an individual to not try or complete something|Jealous people will always try to dissuade you from trying to be successful.|
Distal|something that is distant from something else|The paramedics were concerned with their patient’s distal pulse because there was a lot of time between beats.|
Distance|an amount of physical space between two things|The distance between Earth and the Moon is considerable for us to consider, even though it is almost nothing compared to the true vastness of space.|
Distant|far enough away to be out of immediate reach|I wanted to change the channel, but the remote was just distant enough that I would have to get up to grab it, and I didn’t want to move.|
Distant|far away from each other physically or in time|The most distant celestial body from the Sun in our solar system is Pluto, a dwarf planet at the farthest reaches of our immediate space.|
Distaste|dislike or mild disdain for something|I have a mild distaste for anything bitter, but I would certainly eat those foods if I were hungry enough.|
Distasteful|unpleasant or offensive; causing dislike|Donning a distasteful outfit, the protester’s offensive garb made many people upset.|
Distemper|an infectious viral disease found in animals, especially dogs|The puppy was vaccinated for distemper and several other viral respiratory diseases.|
Distend|to become larger from internal pressure|The hernia caused his stomach to distend from organ misplacement.|
Distill|to extract out the essential meaning or most important pieces of something|Though he didn’t know some of the words, the reader was able to distill most of what the author was saying.|
Distinction|a clear difference or contrast between similar people or things|Although they are identical twins, there is a noticeable distinction between the colors of their hair.|
Distinctive|specifying as unique, special or characteristic|The only distinctive quality of this job candidate was his ability to speak to clients calmly because his clerical skills were a mess.|
Distinctness|being easily distinguishable from other things due to particular attributes|People have distinctness about them, possessing traits in both appearance and personality that set them apart from one another.|
Distinguishable|being able to clearly see or hear something from within a whole and recognize it as different|The fuzzy words on the page were only distinguishable after Mike put on his glasses.|
Distinguished|describing something that is noteworthy or otherwise significant for some reason|The General is a distinguished officer, having performed admirably in two wars and being directly responsible for victory in three major battles.|
Distort|to bring something out of shape or to misrepresent|My friend had an app on her phone that would distort our faces in amusing ways.|
Distortion|an irregularity or abnormality in the shape or perception of something|After getting hit by a flashbang, the victim suffers severe distortion in their ability to both hear and see.|
Distract|to misdirect attention from one focus to another usually as an act of deception|During the Trojan War, a great wooden horse was sent to distract the soldiers and allow the enemy Greeks to enter Troy and win the war.|
Distraught|so upset that one cannot behave normally|When my father died, I was so distraught I dropped out of school.|
Distress|physical or mental anguish|The anxiety attack left me in a bit of distress.|
Distribute|to divide into portions and dispense|Churches often distribute pamphlets to invite people to attend their Sunday service.|
Distribution|the provision of goods and materials to multiple recipients|Multiple people won the contest held by the state, but they would have to wait for the prize distribution to take place a month later.|
Distributive|related to the act of giving or spreading out|The distributive center is in charge of getting all of the products made at the factory out and into the stores.|
District|an area of a country or a city|Moving to a new district, it was difficult for the student to adjust to his new school.|
Distrust|doubt in the ability to trust someone or something|I have always had a strong distrust for politicians, as they never seem to follow through on the promises they make to the public.|
Disturb|to bother or concern someone|The sight of all the violence that was taking place during the riots served to disturb my mother, who was always a bit on the naïve side.|
Ditch|to get rid of something|Michael was willing to ditch his baseball cap and jeans for a wedding day suit.|
Dither|to hesitate or be indecisive|Terry tends to dither when someone asks him where to have lunch, as he is never able to decide on a restaurant.|
Ditto|that which was stated before, the aforesaid, the above, the same, likewise|When I took notes for class, I used ditto marks to show repetition.|
Ditto|a word or mark used to agree with something said or to avoid repeating something|“Ditto,” said Alex when agreeing with his friend that strawberry pie is the best kind.|
Diurnal|energetic during the daylight hours|Because bats are not active during the day, they are not diurnal creatures.|
Diverge|to separate into different directions|The interstate began to diverge into two exit ramps.|
Divergence|the process or state of separating|The married couple is currently in a state of divergence, going through the divorce process so they can legally separate.|
Divergent|different from each other or growing further apart|There were also divergent attitudes towards industrialization in China and Japan.|
Diverse|composed of different people or features|The restaurant has a diverse menu that includes entrees from all over the world.|
Diversify|to make something less uniform by adding different things to it|Many producers attempt to diversify their films by casting actors of many different nationalities in them.|
Diversion|a distraction or turning from another activity|Soldiers often use a diversion tactic, like a small attack away from their target, to sneak up on the enemy.|
Diversity|an assortment of different types|As a teacher, Bridgett has to deal with a large amount of diversity in her inner city classroom.|
Divert|to shift from one thing or another or to distract someone|I decided to divert the conversation away from the topic of politics.|
Divest|to deprive of or strip away|Divest yourself from the company of evil men or you will learn to mimic their ways.|
Divide|to split or separate something into two or more parts or groups|I am in love with books and have to divide my day into house chores, time to write and time to read.|
Dowdy|unstylish, especially in reference to apparel|The clothes I was wearing were apparently too dowdy for the popular kids to acknowledge them, but I really didn’t care for their sense of style.|
Downcast|feeling sad, depressed, or despondent|My daughter was extremely downcast when she couldn’t get ice cream, but I promised her we would go to the park later.|
Downfall|a loss of power or prestige|The downfall of the Soviet Union was likely due to the unhappiness that they brewed in the hearts of their own people.|
Downgrade|to reduce in rank or importance|After many years alone, the aging single was forced to downgrade her expectations.|
Downgrading|reducing something to a lower rank, level, or grade|Since he no longer needs the program for school, the student is thinking of downgrading his account to the free version.|
Downhill|toward the bottom of something|The ball rolled downhill from the top of the slope to the bottom of the mound.|
Downpour|sudden, heavy rainfall|Because her windshield wipers were broken, Beth had to pull over until the downpour stopped.|
Downright|complete or total|There has been so much downright terrible things happening in the world lately that some people are afraid to even leave their homes.|
Downsize|to make something smaller or lessen|When we downsize into a smaller house this fall, we will have to get rid of a lot of our extra furniture.|
Downtrodden|oppressed; exploited.|Hanging his head low, the downtrodden slave felt as if his life was without meaning.|
Downturn|a decline in business or the economy|A downturn in the real estate market made it really difficult for realtors to sell houses.|
Dowry|property or payment given at time of marriage|Part of her dowry included land that her father would give her husband.|
Doxology|a Christian hymn or verse|The doxology at the end of the Catholic prayer was chanted by the patrons.|
Doyen|a man who serves as an expert as the senior member of a group|The doyen of the group joined the Boy Scouts of America before any of the other members.|
Doze|to nap lightly|The wife always joked that her deep-sleeping husband could doze in the middle of a hurricane.|
Dozen|a quantity of twelve|A dozen donuts were served to the twelve breakfast guests.|
Drab|dull; lacking brightness or enthusiasm|Somber and drab, the gloomy hospital room made the depressed patient even sadder.|
Draconian|harsh and cruel|Giving someone a life sentence for stealing a loaf of bread is a draconian consequence.|
Draft|a first version of something written or drawn|Before I submit my final article, I need to edit my draft.|
Drag|to pull someone or something often roughly and through or across an area|The soccer players drag the heavy duffle bags into the locker room.|
Dragnet|a police set-up put in place to catch a criminal|Concealing his badge, the officer prepared the dragnet for the citywide drug sting.|
Dragoon|a British soldier mounted on horseback|Training of the British dragoon included lessons in horse-riding as well as fighting while mounted.|
Drastic|extreme or severe|She was so brokenhearted after the breakup that she considered taking drastic measures to win him back.|
Drat|an expression used when one wants to express irritation or annoyance|“Oh, drat!” Harriet exclaimed when she realized she had left her wallet at home.|
Draught|a current of air|Since Billy didn’t shut the glass door completely, his mom could feel a small draught.|
Drawback|a disadvantage or downside|The cruise to the Bahamas offered many perks, but the overall price was still a drawback.|
Drawl|a type of accent branded by slow and drawn out speaking that is usually related to the southern United States|The old banjo player’s songs seemed to go on and on as he picked and sang along in a Southern drawl.|
Drawn|showing wear from being overworked or not cared for|The student’s once healthy face looked drawn after several late-night study sessions.|
Dread|a feeling of intense fear and anxiety|The extremely shy speaker was filled with dread as she stepped in front of the microphone.|
Dreadful|extremely terrible or awful|The dreadful heat beat down on the farmhands, making their day’s work even more grueling.|
Dreamt|imagined or fantasized about something or someone|The love-sick man dreamt about the day he would finally marry his true love.|
Dreary|cheerless, bleak, and dull|The rainy weather was putting me in a dreary mood.|
Dreck|flimsy or cheaply made|Bargain hunters are always looking for products that are low in price but not dreck or of low quality.|
Dredge|a huge, power shovel used to remove dirt and other debris from a channel or riverbed|The workers used the dredge to remove sediment from the shallow sea.|
Dregs|the least wanted parts or persons|People who think homeless people are the dregs of society do not realize they could be down-and-out too.|
Drench|to cover abundantly|Everyone gasped as my little sister used ketchup to drench every piece of food on her plate.|
Dungeon|an underground prison, usually of a castle|The king’s dank and chilly dungeon kept the most notorious offenders in the city.|
Dunnage|a person's belongings, especially those brought on board ship|Loading the dunnage on the ship was a tough job since the passenger had packed for a three month stay.|
Duo|a pair or couple, usually associated with one another|Minnie and Mickey Mouse are the most famous duo in Disney history.|
Dupe|to deliberately mislead someone or the person who is easily used or tricked|My brother is a schemer who is always trying to dupe people out of their money.|
Duplex|a house divided into two separate apartments|Both sides of the duplex are currently being rented.|
Duplicate|an exact copy of an original|The man’s duplicate license replaced the original that he lost.|
Duplicity|dishonest behavior that is intended to trick someone|Most politicians use duplicity to deceive voters just long enough to get their votes.|
Durable|able to stay in good condition, withstand wear and damage; strong|The plate was made of durable plastic and didn’t break when accidentally dropped.|
Duration|the time period in which something occurs|The total duration of the film is 180 minutes.|
Duress|force or threats meant to make someone do something|The judge overturned the case because the defendant’s attorney proved that his client’s confession had been given under duress.|
Dusk|the darkest part of the evening|The boy’s mother warned him that he must be back inside before the streetlights came on at dusk.|
Dutiful|responsible; devoted|A dutiful daughter will care for her parents in times of difficulty.|
Dutifully|performing responsibilities as expected|The Navy Seaman dutifully painted the ship gray as required by the military.|
Duty|a responsibility or obligation|As an American, it is your duty to vote on Election Day.|
Dwarf|a mythical creature that is short in stature|Without a step stool, it was difficult for the dwarf to get anything done around the cabin.|
Dwell|to live in a specific place|The migrant worker did not intend to dwell in the rural town for very long.|
Dweller|a person who lives in a particular place|The apartment manager offered the dweller a month of rent free living in exchange of a new lease signing.|
Dwelling|a place where people live|An adobe dwelling was made from dirt and other organic materials.|
Edema|an increase in the size of an area of a person’s body due to excess fluid|Once the pain was too much to bear due to Kevin’s edema, he was admitted to the hospital to drain the water pooling under his skin.|
Edge|the rim or border of a place or thing|As the hikers reached the edge of the forest, they realized they would be walking across a large field next.|
Edgy|jumpy and tense|After the plane continued to shake uncontrollably, the passengers began to get edgy for fear of the plane crashing.|
Edible|that can be eaten without harm; eatable|Mom’s dinner was barely edible so I ordered takeout instead.|
Edict|an order made by a person or body of authority|The principal’s edict prohibits female students from wearing skirts and dresses that do not cover their knees.|
Edification|moral, intellectual, or spiritual improvement; through encouragement and instruction|Professor Tom likes to have his students fill out this questionnaire for his own edification as to whether he is omitting anything they’re interested in studying.|
Edify|to teach in a way that improves the mind or character|As good Christians, we must seek to edify our neighbors about God and Jesus Christ.|
Elegy|a poem or song displaying grief or mourning|Since I am not an animal lover, I could only sigh as Ann sang an elegy for her dead cat.|
Element|a specific portion of something |The detective needed to find the final element of the puzzle in order to identify the killer.|
Elemental|fundamental; essential|An elemental requirement for the program is a 3.0 GPA.|
Elementary|pertaining to the basic or fundamental part of a topic|Once the child graduated from his elementary school, he would have to go through middle and high school.|
Elephantine|resembling an elephant|She adds elephantine memory, social charm, and striking vitality to the marketing business.|
Elevate|to increase in distance |“Elevate your legs so the blood won’t flow as fast to your injured foot,” the coach yelled to his injured player.|
Elevation|the altitude between two points|Ms. Smith worried that the low elevation of the city would cause the forecasted rainstorms to flood the land.|
Elevator|a device used for raising and lowering people in multi-floor buildings|She rode the elevator to the second floor of the apartment building which is where she lives.|
Elfin|waiflike or fragile|Due to her elfin frame, many soccer players were afraid that their teammate would get injured easily if their opponent ran into her.|
Elicit|to draw out or bring forth|The comedian hoped his jokes would elicit a great deal of laughter from the audience.|
Elide|to leave out or omit|The teacher decided to elide the last test since most of the students failed.|
Eligible|the ability or qualifications to meet or fulfill a stipulation|Mary was eligible for rehire with the Thompson Paper Company because she was simply laid off from her secretarial position the year before.|
Eliminate|to totally do away with something|Diet pill advertisements claim that they can eliminate belly fat by taking just a few pills a day.|
Elimination|the complete destruction or annihilation of something|Because our enemy does not take prisoners, we will face total elimination if we even think of surrendering to them.|
Elision|omitting sounds in order to make something to easier to pronounce|Elision occurs in Latin poetry as a stylistic device where phrases are omitted.|
Elite|individuals who are viewed as the finest in a group or society|Because Anna is quite wealthy, she sends her children to the area’s most elite school.|
Elitism|the belief that one's social group is superior to others|Spreading their elitism across Germany, the Nazis pushed to prove they were superior to all other races.|
Elixir|a substance or liquid which is believed to cure illness and give eternal life|The salesman was selling an elixir that he said would protect us all from the plague.|
Elliptical|oval or egg-shaped|I painted the elliptical shaped Easter egg with pastel colors.|
Elocution|the way in which an individual reads or speaks in front of others|During the play, the actor’s elocution was so magnificent the audience grew bored whenever he was not on stage.|
Elongate|to make something longer|In an attempt to elongate her body, the dancer stood on her tiptoes and stretched her arms up to the sky.|
Elope|to run away in order to get married|The couple’s dream was to elope in a Vegas wedding with Elvis leading their ceremony.|
Eloquent|having or showing the ability to use language clearly and effectively|When you listen to the eloquent politician speak, you always understand his message.|
Elsewhere|referring to some other place|Since we couldn’t find any of the supplies at the grocery store, we decided to look elsewhere.|
Elucidate|to make clear or easy to understand|To make life easy for my math students, I go out of my way to elucidate the complex problems before each test.|
Elude|to avoid something or someone|The criminal was able to elude the police in the crowded mall.|
Elusive|difficult to find, catch, or achieve|The police are finding it difficult to catch the elusive bank robber.|
Elysian|heavenly; divine|Ancient Greeks prepared to leave their earthly home and rest in Elysian Fields during the afterlife.|
Emaciated|abnormally thin or weak, especially because of illness or a lack of food|Because some sick animals refuse to eat, many of them become emaciated.|
Emacity|the compulsive love for and desire to obtain, purchase, or spend money on items|For Claudia, her emacity was an addiction that forced her to buy hundreds of dollars worth of items she did not need.|
Emanate|to come out from a source|Hopefully, the fun memories of the weekend will emanate throughout the office and give all the employees a positive outlook this week.|
Emanating|coming from|The smoke emanating from the stove was a clear sign something was burning.|
Emanation|a particular thing that is released from a certain source|An emanation will rise through the opening once the humidifier has been running for a while.|
Emancipate|to give freedom to someone|As my father walked me down the aisle, he told me he was happy to emancipate me so I could live my own life.|
Emancipation|the act or process of freeing someone legally or socially|Many slaves became sharecroppers and never left the plantation after emancipation.|
Emasculate|emasculate means to lessen a man’s identity|He was worried his pink pants would emasculate him a bit, but he wore them anyway.|
Embalm|to protect a dead body from rot by inserting it with a chemical compound|In ancient Egypt, people would embalm the bodies of famous leaders by removing the organs and fluids before wrapping it in cloth.|
Embankment|a wall made of dirt or stone that is used to prevent a river from flooding|Sitting on the grassy embankment, the fisherman prepared to throw his line into the river.|
Embark|to begin anew|Tomorrow Grant will start college and embark upon a new phase in his life.|
Embarrass|to make someone look shameful or foolish in public|My mother likes to embarrass me by showing everyone my baby pictures.|
Embarrassment|the state of feeling shame or discomfort with one’s self|With the woman’s sex tape being released this morning, there was no way to avoid public embarrassment.|
Embedded|an object deeply implanted, enclosed, or ingrained within something|After the wind storm, many pieces of wood embedded themselves in the siding on my house.|
Embellish|to make something sound or look better or more acceptable than it is in reality;to make more beautiful and attractive; to decorate|Because Marco has always had a tendency to embellish the truth, no one believed he had been mugged.|
Ember|a glowing piece of coal or wood|The fire was blamed on an ember from the camp fire that had not been fully extinguished.|
Embezzle|to take property or funds one has been entrusted to keep|The teller will be prosecuted if she helped the loan officer embezzle bank funds.|
Emblazon|to decorate something with a noticeable design or symbol|My crafty sister-in-law was able to emblazon my t-shirt with a glittery monogram.|
Emblem|a representative symbol, such as a trademark or logo|The show requires everyone to wear a shirt that sports the emblem of their company so that people can network more effectively.|
Emblematic|serving as a symbol|The American flag is emblematic of freedom.|
Embodiment|an individual or thing that serves as a role model|My lecturer holds several advanced degrees and is the embodiment of the ideal scholar.|
Embody|to stand as a symbol for something|The national flag is supposed to embody the spirit of our country.|
Embolden|to motivate or inspire|Do you believe alcohol commercials embolden teens to drink?|
Embossed|to carve, mold, or stamp a design into something|The graffiti artists embossed their signature designs onto the side of the building.|
Embrace|to clasp someone or each other with affection; hug |I have come to appreciate warm people who embrace me just because they're happy to see me.|
Embrace|to hold someone closely in your arms|Running into each other’s arms, the couple began to embrace each other tightly.|
Embrace|to accept the idea or reality of something|Harold tried to embrace the idea that his wife wanted a divorce, but he still had a hard time accepting it.|
Embroider|to decorate cloth by sewing patterns on with thread|I had my mother embroider my initials on my jacket so none of the other kids would take it home.|
Embroidery|needlework|Doing extra embroidery work on the side, the talented seamstress enjoyed doing needlework.|
Embroiled|pulled into a situation|I avoided my two best friends because I did not want to get embroiled in their dispute.|
Embryo|an organism in the earlier stages of development before it emerges from the egg, or before metamorphosis|Before I was a baby, I was an embryo.|
Embryonic|referring to a system or idea that has potential for significant development|Our company is still in its embryonic stage, having just started and having a lot of room to grow and expand.|
Emendation|the action of fixing written errors|Fortunately, John’s first draft of his paper required only a single emendation before it could be submitted for a grade.|
Emerge|to come forward or appear|Who will emerge victorious at the end of the boxing match?|
Emergency|a situation which poses an immediate risk and requires urgent attention |The family gathered into the hospital’s waiting room when my grandfather needed an emergency surgery to remove a blood clot from his brain.|
Emergent|in the process of emerging, of coming into being or prominence|The emergent young singer may not be famous yet, but his great talent points to a future in show business.|
Emeritus|retaining a title of honor after retirement|Barack Obama is the emeritus President of the United States.|
Emesis|throwing up; barfing|Because some patients experience emesis after surgery there are always basins in the recovery area.|
Emigrant|a person who leaves their home country to live permanently in a new country|Marco is an emigrant from Cuba, which is immediately obvious from his accent.|
Emigrate|to move from an individual’s home country to another country|Many Mexicans illegally emigrate into the U.S. from Mexico.|
Emigration|the act of relocating to another region or nation|Because of the high rate of emigration, our country’s population is decreasing.|
Eminence|having a superior or famed ability at a specific activity|Taylor Swift’s eminence as a creative singer and style icon make her one of the most well known celebrities in the world.|
Eminent|remarkable, great|Everyone was looking forward to taking the class with such an eminent professor.|
Emissary|an individual who acts on behalf of another person|The celebrity sent his assistant as an emissary to pick up the movie contract.|
Emission|the act of releasing or sending out something|The mechanic is checking the engine to identify the source of the emission coming from my car.|
Emollient|something which softens or lubricates the skin|The lotion was a great emollient for her dry skin.|
Emolument|compensation for work completed|The emolument I earn from working is not enough to pay my bills.|
Emotion|an instinctive or intuitive feeling, as opposed to logic and rationale|Happiness is an emotion that we all wish to experience throughout our lifetime in spades, but unfortunately we must all endure tough times.|
Emotional|of or relating to the emotions|After more information unfolded, it appears the woman in question has severe emotional issues that should be dealt with.|
Emotional|connected with or showing feelings|The woman and man had an emotional connection and expressed their feelings for each other over the phone.|
Emotive|emotional|I didn’t expect such an emotive response from the parent when I said that her son was not a nice child.|
Empathize|to feel empathy for another person|His ability to empathize with people made him an excellent marriage counselor.|
Empathy|to understand and share the feelings of another|Because her parents immigrated to the United States to give her a better life, Maria has empathy for illegal aliens.|
Emperor|the male supreme ruler of a kingdom or empire|Looking down from his throne, the emperor ordered all of the thieves to be banished from his kingdom.|
Emphasis|special importance or prominence on a particular thing|The teacher put special emphasis on the fact that the assignment was not due tomorrow, but the day after it, to make sure we wouldn’t forget.|
Emphasize|to highlight or focus on|You should use the blue eye shadow to emphasize your beautiful eyes.|
Emphatically|firmly|When my husband and I married, we agreed emphatically to stay together forever.|
Empirical|based on observation or evidence|Our data is based on empirical evidence collected in numerous studies.|
Empiricism|pursuit of knowledge purely through experience and experiments|The expert’s sense of empiricism stemmed from years of personal experience.|
Employ|to make use of something or hire somebody to work|The boutique was looking to employ fashion designers.|
Employment|the state of having a job or paid work|I have applied for several different jobs, but am yet to find full-time employment.|
Empowered|acting with confidence|After being praised to the sky, Jack felt empowered and was ready to tackle the job.|
Empowerment|power or authority given to someone|The women’s empowerment movement was all about helping women take control of their own lives.|
Emptiness|the state of containing nothing|After all of her children left home, the mother felt a sense of emptiness in her lonely heart.|
Empty|unable to satisfy; hollow; vain|My neighbor’s apologies were empty gestures and nothing more.|
Emulate|to imitate and copy; strive to equal or excel|Aspiring to become a good cook, Kate will emulate the recipes and cooking techniques of chef Emeril.|
Emulation|the desire to equal or excel someone else in qualities or actions|Growing up, Rick was absorbed with sports emulation and he wanted to play for the Jets one day.|
Emulous|full of jealousy that leads one to be eager to copy another|The teen’s emulous personality led her to copy the other girl’s style instead of embracing her own sense of fashion.|
Enable|to make something workable or possible|Earning a college degree will enable Jake to get a job that pays a decent salary.|
Enact|to authorize as a law or decree|Congress hopes to enact a law that will increase the consequences of drunk driving.|
Enamor|to trigger feelings of adoration|My daughter hopes her makeover will enamor feelings from her secret crush.|
Enamored|in love with a person or thing|Because I was so enamored of my boyfriend, I had to see him constantly.|
Encampment|temporary living quarters|The Native American encampment was set up close to where the buffalo roamed, providing a temporary home for the hunters following the herd.|
Encapsulate|to concisely express the main point of something |The students wished there was a way to encapsulate their teacher’s lecture so class would end quicker.|
Encase|to cover something in a case or close-fitting surroundings|The foil was used to completely encase the meat before it was put in a pan and placed in the oven.|
Enchant|to charm or captivate|When the magician finished his act, he did enchant the audience with his unbelievable magic tricks.|
Enchanted|charmed, delighted, enraptured|After the performance ended, we sat glued in our seats, enchanted by what we just saw.|
Encircle|encase or enclose around|Police can’t determine what is happening on the sidewalk since the people tightly encircle the pair of fighters in the center.|
Enclave|a faction of individuals who differ from the people who live in neighboring areas|The residents of the wealthy enclave don’t want the public bus system in their neighborhood.|
Enclose|to completely cover or close something off from outside sources|Ancient Egyptians liked to enclose their dead in elaborate tombs.|
Enclosure|an area that is surrounded by a fence, wall, etc|The enclosure was filled with cows grazing in the field.|
Encomium|speech or piece of writing that warmly praises someone or something; tribute|Mrs. Poundstone was surprised and delighted on the last day of school when the students in her most difficult class presented her with an encomium they had written, praising her work as a teacher.|
Encore|a brief extra performance, done after the main performance is complete |After the first encore , the crowd made it obviously clear they wanted more.|
Encounter|to come across something or someone without warning|I never dreamed I would encounter a rattlesnake in my backyard.|
Encourage|to give support and hope to someone in an effort to build their confidence|Trying to encourage his troops to press on, the leader gave a moving speech to the discouraged men.|
Encouragement|words or actions that offer support or confidence to another person|Offering encouragement to her son, Rhonda tried to convince Eli to try out for the basketball team once again.|
Encroach|to slowly move into another person’s area|My coworker is always leaning on my desk and trying to encroach upon my personal space.|
Encumber|to restrict or burden in such a way that action is limited|The chaperon’s rules did not encumber the female members of the swim team from sneaking out of their hotel at night.|
Encumbrance|burden or hindrance|If it weren’t for the encumbrance of procrastination, I would be a productivity machine!|
Endangered|at serious risk of dying out/becoming extinct|The Dodo bird is now extinct since no one was able to mate them when they were endangered.|
Endear|to bring about love or fondness |Your rude behavior didn't endear you to the judges.|
Endeavor|nan|Although soliciting donations to help rebuild the orphanage took a lot of time and energy, in the end everyone agreed it had been a very worthwhile endeavor.|
Endemic|native to a specific area or group of individuals|The poisonous snake must have come from another country because it is not endemic to our nation.|
Endogenous|growing or forming on the inside|Because they are endogenous, the plants roots grow from deep within the plant tissue.|
Endorse|to express one’s support or approval|If the president chooses to endorse the politician, he will lose many supporters who oppose the legislator.|
Endothermic|a reaction that causes warmth to be taken in|Due to the endothermic process of cooking, an egg is cooked and becomes hot by the use of a stove.|
Endow|to bestow something in a natural way or to give funds that are needed to support a project|The billionaire will endow the school of nursing with a huge donation.|
Endowed|supplied or furnished with |Since we’ve been heavily endowed by investors this year, we have greatly exceeded our fundraising goals.|
Endowment|income or property that is given to someone|In an effort to assist my son as he buys his first home, I provided him with a significant monetary endowment.|
Endurance|the ability to do something difficult for a long time|She admired her grandmother’s endurance throughout the grueling cancer treatments.|
Endure|to put up with or go through|A woman has to endure an extreme amount of pain during childbirth.|
Energetic|active; having high levels of energy|I stayed up late last night, so I had a hard time being active and energetic.|
Energy|the power and ability to be physically and mentally active|When people are under stress, they don't have as much energy for physical or mental activity.|
Enervate|to deprive of force or strength; weaken|The wrestler's plan was to deliver a crushing blow which would enervate his opponent.|
Enervated|weakened; derived of strength|Because he wasn’t in great physical shape, the runner felt enervated after a long-run.|
Enfeebled|made physically or mentally weak or feeble|After months in captivity, the enfeebled survivors were too weak to walk out of the camp.|
Enforce|to compel or require|Police officers will enforce the law by arresting people for committing crimes and handing out citations for breaking the rules.|
Enforcement|the process of making sure that people follow a law/rule|Enforcement of the park rules meant that people were not allowed in after dark.|
Enfranchise|to extend privileges or rights|One purpose of the immigration bill is to enfranchise citizenship to people who are willing to make a commitment to this country.|
Engage|to become involved or participate in|If you engage in criminal activity, you could end up in a jail cell.|
Engaging|connecting; joining|Engaging in a heated argument with her husband, the angry wife refused to back down.|
Engender|to cause a feeling or attitude to exist|The restaurant hoped the act of giving out free ice cream would engender customer loyalty.|
Engine|something that is the force or impetus of a process|The tank is our preferred engine of destruction when our country goes to war on the ground.|
Engross|to completely capture attention or focus|Hopefully the plastic keys will engross the crying baby for a while.|
Engulf|to totally surround or cover|The lava will begin to engulf the abandoned city in six hours.|
Engulf|to sweep over something, surrounding it completely|It only took seconds for the raging fire to fully engulf every room in the house.|
Enhance|to bring out positive features|The saleswoman told me the blue dress would enhance my lovely blue eyes.|
Enigma|someone or something that is mysterious and difficult to understand|To the new detective, the motive of the crime was an enigma.|
Enigmatic|full of mystery and difficult to understand|When I was growing up, I viewed my father as an enigmatic man who rarely spent time with me.|
Enjoin|to prohibit someone from performing an action|The angry man wanted the judge to grant an injunction to enjoin his ex-wife from selling their vacation home.|
Enjoyable|entertaining; pleasurable|Going to the beach is usually enjoyable, but today’s heat wave took away from the fun.|
Enjoyment|a feeling of happiness or pleasure gained from an event or activity|Enjoyment of an ice cream cone is one of my favorite summer activities.|
Enlarge|to make something bigger than its original size|The nearly blind woman needed someone to enlarge her text messages so that she could read them.|
Enlighten|to give someone more knowledge or information about a situation|The teacher’s job was to enlighten her students on the various theories of physical science.|
Episode|incident or action connected with a series of events|One in three of us will experience a depressive episode at some time in our lives.|
Epistemic|of or relating to knowledge or cognition; cognitive|As human beings, it is very important to be aware of our epistemic limitations.|
Epistemology|a division of philosophy that examines numerous aspects of human intelligence|“What exactly is knowledge?” is a question you will ask when you study epistemology.|
Epistle|a formal printed communication; a written note or letter|The epistle from the court ordered me to appear as a possible juror.|
Epistolary|associated with written correspondence|Her epistolary collection of the secret romance contains all the letters the couple exchanged.|
Epitaph|a brief literary piece written about the life of a dead person and often placed on that individual’s headstone|The slave’s epitaph stated his name but made no mention of his date of birth or death.|
Epithet|a word or phrase that describes a person or thing|The epithet “Curly” is used to describe the big football player with the curly hair.|
Epitome|an example that represents or expresses something very well|Because our mayor is the epitome of a good citizen, he has been in office for over ten years.|
Epitomized|used as a model of something|Before his career-ending injury, Dwayne epitomized the world’s idea of the best basketball player on the planet.|
Epoch|a significant period in time|Many people consider the development of the first antibiotic to be the epoch of man’s therapeutic advances.|
Epochal|of great significance|The president returned the country to prosperity during his epochal terms in office.|
Eponym|a term derived from an individual or thing related to it or to the person who created a specific thing|The word “sandwich” is an eponym linked to the first person said to have requested the item, the Earl of Sandwich.|
Eponymous|a title or name that is derived from another name|The singer’s first album was eponymous and carried her name as the record title.|
Equable|even-tempered; calm|Because she is so equable, my even-tempered mother rarely gets upset.|
Equal|being the same in size, amount, or degree|You should add an equal amount of water and paint to the bowl get the right mixture.|
Equality|the quality of having the same value or worth|The civil rights activist fought for racially equality so all people would be viewed as equals.|
Equanimity|to stay calm, especially under stress; to maintain composure|His equanimity allowed him to keep a clear head and escape the burning building.|
Equate|to view as being equal in value |I was angry when I learned the insurance check wouldn’t equate to the painting’s purchase price.|
Equation|a mathematical problem that says that two things are equal|Although he knew how to divide, the confused student could not figure out the numbers to plug into the equation.|
Equator|an imaginary circle around the Earth, dividing earth's surface into the northern and southern hemisphere|Even though it is invisible, I am well aware of the equator due to its high suffocating temperatures.|
Equestrian|associated with horse riding|During the equestrian auction, you’ll have the opportunity to bid on some of the finest horses in the country.|
Equidistant|located the same distance from two or more areas |My hotel room is located equidistant from both elevators so neither elevator is more convenient than the other.|
Equilateral|referring to a polygon all of whose sides are of equal length|The equilateral picture frame allowed for a four by four inched photograph.|
Equilibrium|the condition at which competing influences are balanced|Equilibrium is the point at which supply and demand are in balance with enough of a good being produced to meet the requests for it.|
Equine|similar in appearance to or associated with a horse|In high school, people used to bully Gail by calling her “Horsey” because of her equine face.|
Equinox|the two days of March and September in which the hours of the day and night are nearly the same length |In the United States, we are always eager for the March equinox to cast out the winter weather.|
Equip|to supply someone or something with the necessary items for a specific purpose|If you plan on rock climbing, you should probably equip yourself with a harness and the other safety gear needed to stay safe.|
Equipoise|a state of balance; equilibrium|As she stacked the cans into a pyramid, the stocker was precise in order to ensure equipoise and stop the cans from crashing down.|
Equipped|coming with additional items that allow ultimate functionability|The campsite came equipped with a stone fire pit, charcoal grill, and water fountain.|
Equitable|characterized by equity or fairness; just and right; fair|Both sides agreed to try to find an equitable compromise that would please everyone.|
Equivalent|on par or equal to|Carl is a cocky home cook who swears his hamburger is equivalent to a steak at a fine restaurant.|
Equivocal|not clear or certain|Since the defendant’s alibi is equivocal, the jury will disregard it almost instantly.|
Equivocate|to use unclear language especially to deceive or mislead someone|When things are not going Margie’s way, she will often twist the truth and equivocate to put things in her favor.|
Era|a period of time of which particular events or stages in history|The fall of the Berlin wall marked the end of an era.|
Eradicate|to completely destroy; to put an end to|The murderer conceived a sinister plot to systematically eradicate the any witnesses to his foul deed.|
Ere|previously or earlier usually meaning with time|The southern belle hoped Jeff would ask for her hand in marriage ere nightfall so that she could go to bed early that night.|
Ergo|consequently or therefore|I am allergic to shellfish; ergo, I will not be trying Pam’s shrimp pasta dish.|
Eristic|describing a person likely to debate or argue with others|My Dad is a very eristic person, always turning any conversation we have into a full blown debate for no reason.|
Erode|to destroy something at a leisurely pace|People predicted the Internet would erode the future of newspapers, and for the most part, they were correct.|
Erosion|the slow demolition of something |The overconsumption of soft drinks can produce dental erosion.|
Err|to make an error or mistake|When I err, I try to learn from my mistakes.|
Errant|not following the appropriate course|The errant student was given a warning for not going directly to class.|
Erratic|unpredictable|The medicine causes the normally predictable Jacob to behave in an erratic way.|
Erratum|an error in text that is later corrected |An erratum at the bottom of the article contains a correction for a spelling error.|
Erroneous|wrong; incorrect|After he had spent every waking moment of the past few days researching the subject, he was understandably frustrated when he discovered that several of his sources contained erroneous information.|
Error|a mistake or blunder|When the mother accused her son of stealing her money, it was an error on the mother’s part because the daughter actually stole the money.|
Ersatz|replicated from something else yet lacking the original qualities|Do you believe the ersatz beach created by the city will appeal to those who love the natural features of the seashore?|
Erstwhile|in the past|Before she began using a pseudonym, the author was erstwhile known by another name.|
Erudite|having or showing profound knowledge|The room was full of erudite scholars who made the discussion on astronomy fun and interesting.|
Erudition|extensive knowledge learned from studying and research|Ken Jennings is a man of great erudition, having won first place on Jeopardy 75 consecutive times.|
Erupt|to violently eject|Fearing that the volcano would erupt momentarily, the local authorities issued an immediate evacuation notice.|
Erupted|simple past tense and past participle of erupt, to violently eject or explode|After he said the words “not guilty,” the audience erupted.|
Eruption|the bursting out of material suddenly and violently|The volcano’s sudden eruption left the city in ruins, covered in lava and ash.|
Escalade|the act of climbing or scaling defensive walls with the aid of ladders|Even the strongest men were unable to escalade the tower of the north castle.|
Escapade|a risk-taking act that goes against normal behavior|The boys’ escapade might end with their arrest.|
Escapism|avoidance of the real world and finding comfort in daydreams and fantasy|Escapism was his favorite pastime, preferring to immerse himself in video games over homework.|
Escarpment|long, steep cliff|Sledding down the steep escarpment proved to be a hair-raising event.|
Eschew|to avoid something which you do not think is right or proper|Since my husband believes chores are a woman’s work, he tries to eschew them around the house.|
Escort|to go with someone or something as a companion or guard|No women in the city are allowed to shop or be in public without a male family member to escort them.|
Escrow|money or something of value held in trust by a third party for two other parties in a contract|When my parents died, I inherited money that will be in escrow until I turn twenty-one years old.|
Esculent|edible; good enough to eat|Compared to the other mouthwatering apples, the one with the worm’s head poking out of it was not esculent.|
Escutcheon|a shield displaying a coat of arms|Shining brightly, the warrior’s shield-like escutcheon had protected him in many battles.|
Esophagus|tube that carries food, liquids and saliva from your mouth to the stomach|Forcing the sashimi down her esophagus, the finicky woman tried not to think about the fact that it was raw.|
Esoteric|known about or understood by very few people|The medical research was so esoteric that only a few physicians could actually understand the results.|
Especial|exceptional|With especial grades, the student knew she would get into the college of her choice.|
Espionage|the obtaining of information considered secret or confidential without the permission of the holder of the information|Digging through someone’s trash to get information is one of the oldest acts of espionage in the spy business.|
Espouse|to support an idea, belief, or principle|People who espouse the Paleo diet claim that they feel better and it’s much easier to control their weight.|
Espresso|dark coffee brewed by forcing water through finely ground, roasted coffee beans|A cup of expresso was just what the coffee junkie needed to get her day started.|
Esprit|the quality of being lively and spirited|Several of the esprit cheerleaders were able to liven the crowd even though the team was losing.|
Essay|a written composition of moderate length, exploring a particular issue or subject|For a homework assignment, our teacher Mr. Jones wants the class to write an essay on endangered species.|
Essence|the key element of something|At the essence of the non-profit is the desire to improve the lives of homeless people.|
Essential|absolutely necessary; extremely important |Air and water are essential for human life.|
Essentially|basically; mostly|Since the game is essentially over, we should go ahead and walk back to our cars.|
Establish|to create or form|The teacher must establish rules for the students to follow while they are in school.|
Established|referring to something that has existed for a long time and is therefore recognized|Italy has long been established as a country of good food, probably thanks to their donation of pizza and pasta to the world cuisine.|
Establishment|the people with the most power within a government|Because the establishment had all of the power, it was hard for a peasant to rise above servitude.|
Estate|all of the property owned by a person, typically at the time of their death|My estate includes my house, my car, my dog, and all of my money, which will all go to my wife if I die.|
Esteem|respect and admiration|Having set the world record for fastest mile time, the man received the esteem of his fellow runners.|
Esteemed|having the admiration of others|We are honored to present this award to our esteemed colleague for his hard work and dedication.|
Estimable|worthy of respect and praise|Our estimable professor is constantly being recognized for his cancer research.|
Estimate|to roughly calculate or give a guessed amount|I always estimate the cost of my groceries while shopping so that I’m not surprised at the total amount.|
Exceeding|more or greater than average|Having exceeding expectations, the teacher required high quality work with no errors from all of his students.|
Exceedingly|extremely; to a great extent|As my debt rose and income increased, it seemed exceedingly difficult to survive month to month.|
Excel|to do something extremely well|I tend to excel in subjects that are heavy in mathematics, but struggle with courses that require a great deal of writing.|
Excellence|the state of being extremely good|Committed to excellence, our basketball team refused to give up when we were behind in the first round.|
Excellent|wonderful and superb|After studying a few hours for his math test, the boy was proud for making an excellent grade of an A+ on his test.|
Exception|a case where a rule does not apply|The only exception that will be made for students who come late to classes is if they had been sick the day before.|
Exceptionable|objectionable or not acceptable|The nursing home worker’s exceptionable treatment of the patient led to complaints and termination.|
Exceptional|excellent or brilliant|Tiffany had exceptional grades with straight A’s and they were all at one hundred percent.|
Excerpt|a short piece or clip from a larger piece of media |Since we had only a few minutes left in class, our teacher could only read an excerpt of the short story to us.|
Excess|surplus; extra|Excess annual funds should be designated to the building fund so that we can make the needed roof repairs.|
Excessive|more than needed|Excessive spending by the state government drained our funds and left us with a huge deficit.|
Excessively|something that is done in an extra amount or extent than what is expected|Since the young child was always silenced at home, she talked excessively at school about anything she could think about.|
Exchange|to trade or swap|After the small fender bender, the two parties decided to exchange phone numbers and sort the issue out at a later date.|
Excise|to get rid of something by cutting|It will take several hours for the surgeon to excise the massive tumor.|
Excitable|easily excited; emotional or temperamental|It didn’t take much to get the excitable puppy riled up and a bark fest to being.|
Excite|to stimulate and thrill|Several half-court three point shots were able to excite the crowd and send them into a frenzy.|
Excitedly|to be thrilled or interested|The 16-year old boy said excitedly, “I can’t believe you got me a brand new car for my birthday!”|
Excitement|full of delight|Excitement on a child’s face when she comes downstairs on Christmas morning to see all her presents is priceless.|
Exciting|thrilling and interesting|When my wife announced we were having a baby, the exciting news made me go buy a house full of baby toys.|
Exclaim|to speak spontaneously and with strong feeling|If you listen on Christmas Day, you'll hear millions of small children exclaim in joy.|
Exclaimed|expressed with strong feeling|It was obvious from the way the children exclaimed delight that they liked their Christmas presents.|
Exclamation|a sudden cry usually brought on by surprise, anger, or pain|I let out an exclamation of anger when I realized my best friend had accidentally spilled paint on my drawing in art class.|
Exclude|to eliminate or reject|If an African American citizen tried to vote in the 1950s, the workers would exclude him based on his race.|
Exclusion|the condition of denying access to something|Due to his exclusion from the military, Darrel didn’t know what he was going to do in the future.|
Exclusive|private; restricted|Although the pool was exclusive to paid members, we usually were allowed to swim after hours.|
Excogitate|to study something intently and carefully|The attorney took several days to excogitate the case documents so that he would be prepared for court.|
Excommunicate|to be banished from a church|In history, officials have decided to excommunicate prominent religious leaders because of their wrongdoings.|
Excommunication|officially excluding someone from participation in religious acts of the Christian Church|The penalty for joining a secret group like the Freemasons was exile and excommunication from the church.|
Excoriate|to severely condemn|In his speech, the president will excoriate the dictator’s actions and state his plans for military intervention.|
Excrement|feces expelled through the body after digestion|Cleaning up the patient’s excrement out of the bedpan was not the highlight of the nurse’s day.|
Excrescence|a protrusion or growth usually in the form of a lump that is the result of sickness|After discovering a large excrescence that resembled a bubble on his leg, Miles went to the doctor to have it looked it.|
Excretion|the process of expelling waste from the body|Taking part in the excretion process, several organs are responsible for removing waste for the body.|
Excruciating|extremely uncomfortable or painful|After watching the excruciating film, I thought about asking for a refund of my money.|
Exculpate|to clear of or free from guilt; exonerate|Diane’s teenage son is constantly getting into some kind of mischief, but he knows how to charm his mother and exculpate himself.|
Exculpatory|describes something that shows or declares that (someone) is not guilty of wrongdoing|Despite its exculpatory tone, those conducting the investigation know in their hearts that the president is guilty of perjury.|
Excursion|a fun outing or visit|On our excursion to see our grandparents in Colorado, we ran into a snowstorm which delayed our trip.|
Excuse|the justification for an error, mistake or absence|Her only excuse for stealing the bread was that her young brothers would starve to death if they weren’t fed.|
Execrable|extremely bad or unpleasant|When Matt accidentally found himself on a racist website, he was outraged by all the execrable comments that had been posted on it.|
Execrate|to strongly condemn an individual or thing|After being injured in the war, my uncle came to execrate gun violence.|
Execute|to put a plan or order into effect|We were unable to execute our beach plans since the weather wasn’t in agreement.|
Execution|the act of performing a task or command to its completion|The superintendent of the school system knew that the successful execution of the standardized test would require a thoroughly planned system.|
Executioner|the person who discharges the death of a death penalty criminal |The protocol for the hanging included draping a dark cloth over the criminal’s head before the executioner released the trap door.|
Executive|a high-ranking employee in a company or business|Once the strict executive of the Zanda Office Supply Company realized some employees were stealing pens and paper, he fired every one of them.|
Executor|a person who is authorized to make sure the conditions in a will are fulfilled|When the executor read the will, all the family members listened intently.|
Exegesis|detailed explanation of a written passage|The student’s exegesis of the novel was one of the best summaries the professor had ever read.|
Exemplar|a person or thing that serves as a model or ideal|The school valedictorian is an exemplar of the perfect student.|
Exemplary|something so good that it is an example for others to follow|When my father retired from his company after fifty years of employment, he received a gold watch for his exemplary service.|
Exemplification|the act of providing a sample, illustration or instance|Lieutenant Sanders was an exemplification for the younger soldiers because he had rescued twenty troops during an attack.|
Exemplify|to show or illustrate by example|The citizenship trophies are presented to exemplify the best examples of good citizenship among the student body.|
Exempt|free from a responsibility or obligation that is placed on others|Because I made a perfect score on my last exam, I am exempt from the study guide that all of the other students are required to complete.|
Exemption|the act of being excluded or immune to a task or obligation|When I explained that I was working a very important job that only I could do, the judge gave me an exemption from jury duty.|
Exercise|to put something to use such as rights or powers|States must take effective measures to ensure that all persons entitled to vote are able to exercise that right.|
Exeunt|a printed direction for actors and actresses to leave the stage of a play|In the Broadway musical, the command was written in the script for the main characters to exeunt stage left because their part was over.|
Exfoliate|to remove dead skin and cells from the face or body using a gritty scrub|Many women choose to exfoliate their skin in order to expose the new skin underneath for a smoother appearance.|
Exhalation|the process of releasing air from your lungs|After puffing on a cigarette, the inconsiderate man’s exhalation of the second-hand smoke created a hazard for anyone standing near him.|
Exhale|to release air from your lungs|Synchronized swimmers wait as long as possible to exhale so that they can hold their breath for a long time.|
Exhaust|to wear out or use up one's resources or materials|The marathon runner began to exhaust at mile 23.|
Exhausted|to be very tired having little to no energy|After the colicky baby arrived, the new parents became exhausted from lack of sleep.|
Exhaustive|leaving nothing out; thorough|Despite an exhaustive search of the apartment, I could not find my car keys.|
Exhibit|to purposefully show or reveal something|Since the students want to impress their teacher, they exhibit perfect behavior in their class.|
Exhibition|an event at which objects such as paintings are shown to the public|The art exhibition featured pieces from famous painters around the globe.|
