Outfit|to provide with attire or equipment|We will need to outfit our soldiers with the proper protection if we want them to survive the rigors of combat.|
Outfox|to con or trick someone using keen and smart ways|Using his wit and finesse, the veteran defense attorney was able to outfox any lead witness into saying incriminating information about themselves.|
Outgoing|sociable and friendly|Due to her outgoing personality, Kim made friends who always wanted to be around her.|
Outlaw|a criminal who has disobeyed the law but has not been captured yet|Everyone who passed by the wanted poster of the dangerous outlaw wanted to find him so they could get the reward money.|
Outlet|a large tube or opening where water flows out|All my neighbors realized that my carpenter’s drill hit the underground pipe because water spewed from the outlet flooding my yard.|
Outlier|an outsider|The scholarship student was treated as an outlier by her wealthy peers.|
Outline|outer edge of lines of a person, item or thing|So that the text box would be noticeable on the poster, I decided to outline the box with a dark black marker.|
Outlook|viewpoint on a topic|Many men have a negative outlook on marriage because they are so scared of commitment.|
Outnumbered|to be more than some other number or amount|Knowing that they were outnumbered by their opponent, the small army decided to retreat from the battle.|
Output|an object that is manufactured or created|With hopes of increasing the amount of output of their computers, the factory hired several more workers.|
Outrage|very mad with fury|Outrage over the recent election resulted in many millions of people rioting in the streets in order for people to hear their point.|
Outraged|mad; upset|Outraged by the politician’s phony promises and unethical policies, the masses revolted.|
Outrageous|shockingly distasteful or terrible|My stern mother does not tolerate outrageous behavior at the dinner table.|
Outre|weird and shocking|During the Victorian era men wearing wigs were considered normal, but today it is thought to be outre.|
Outreach|to offer or give aid or service|When the police officer gave his new shoes to a homeless man, this outreach of sympathy was appreciated by the man.|
Outright|to do something completely or instantly|Kathy responded outright to the question that the teacher was asking even though the teacher asked the students to quietly write down their answers.|
Outset|at the start of something|Every character at the outset of the book was fully developed so that the reader knew everything about the characters prior to the plot.|
Outshine|to surpass someone or something in ability or achievement|The cheerleading squad is very competitive, so all of the girls on the team try to outshine each other.|
Outside|the external or exterior area of a place|“Do not color outside the lines,” the kindergarten teacher told her students, “because that would be messy.”|
Outskirts|the outer edge of an area or town|When Arthur died, he went to the outskirts of heaven before entering the pearly gates.|
Outsource|to contract a job out to another person or place|Many businesses outsource their projects to workers in the Philippines who will work for a much lower wage.|
Outspoken|opinionated and frank|Several of the outspoken candidates resorted to name calling during the presidential debate.|
Outstanding|terrific and wonderful|Samuel made an outstanding catch during his baseball game by reaching over the back wall to catch the ball.|
Outstretched|to extend or stretch out|Katie smiled and nodded as the senator shook her outstretched hand.|
Outstrip|to move further|Being trained for the Kentucky Derby, these horses outstrip any of the other horses running down the track.|
Outweigh|for something to be more important or further along than something else|Since the job paid much less and was more difficult, its disadvantages definitely outweigh the benefits.|
Outwit|to be more cunning or brilliant over someone else|In the song, “Devil Went Down to Georgia,” the boy was able to outwit the devil by playing his fiddle better.|
Ovation|an excited cheer and clapping after a performance from the spectators|After the blind man played a perfect sonata on the piano, the crowd gave him a standing ovation.|
Overage|an excess or surplus by which a sum of money is greater than previously estimated|The teacher used real money to show students how to calculate an overage or excess funds.|
Overall|all parts, referring to the whole of something|While the overall effectiveness of a squad is the most important thing in the military, it’s the skill of the individual soldiers that make the squad effective.|
Overarching|primary or predominantly|The boss set some overarching goals for his employees that they must work on immediately plus a few minor goals to do in their spare time.|
Overbearing|overly bossy, domineering, or arrogant|Debra has a tendency to act in an overbearing and domineering way which tends to turn Ted off.|
Overblown|inflated or exaggerated|The woman promised her husband that the debt amount listed was overblown and that she didn’t owe as much as the credit card company claimed.|
Overboard|to do something to the extreme|My mother always goes overboard with Christmas decorations, hanging lights and garland on every inch of the house.|
Overcast|cloudy; gloomy|The children wanted to go swimming, but the overcast day made it a little too cool to get into the pool.|
Overcome|to succeed in dealing with a problem or difficulty|Ted knows that he would have no problem speaking in public if he would only overcome his fears instead of running away from them.|
Overcompensate|to take extreme measures to correct a perceived weakness, error, or problem|The young mother tried to overcompensate for her lack of experience through buying her child lots of expensive gifts.|
Overdo|to do too much of something|If you overdo it in the gym, your muscles will be extremely sore in the morning.|
Overdone|Overcooked (food)|The overdone steak was so tough that I could barely cut into it with my fork.|
Overdose|to take to much of something, specifically a drug|Medicine bottles now have childproof caps that stop kids from being able to overdose on the pills.|
Overdue|late; past due|The overdue mother’s due date had passed a week ago and she couldn’t wait to have her baby.|
Overeat|to eat too much food|Because so many delicious dishes are served at our holiday dinners, I tend to overeat every Christmas.|
Overemphasize|to overstress or exaggerate|Jessie tends to overemphasize the negative parts of her life instead of focusing on the positive.|
Overhaul|to assess and replace with something better or newer|After the Bolsheviks assassinated the Romanovs, they began an overhaul of the Russian government and completely rewrote the laws.|
Overindulge|to have too much of something you desire|My husband Charlie hid the kids candy they received from Halloween so they wouldn’t overindulge.|
Overjoyed|exceedingly happy|The couple was overjoyed when they found out they were pregnant after being unable to conceive for years.|
Overkill|an unnecessary excess of something|24 hours of TV coverage of the US election verged on overkill.|
Overlap|to extend over something and cover it partially|Because his teeth overlap at the bottom, Charles needs braces to straighten them out.|
Overlay|to cover the surface of something with something else|The girl’s memories started to overlay one another, making it hard for her to know what happened when.|
Overlook|to supervise and direct|When the young man got hired at the restaurant, the manager would overlook the new employee’s work to make sure he was doing his job correctly.|
Overpower|to take over or overwhelm something|The scent of garlic began to overpower the kitchen and could be smelled all the way outside.|
Overprotective|to have the desire or tendency to protect someone (especially a child) excessively|The overprotective mother rarely lets her teenage son out of her sight.|
Override|To use one’s authority to cancel or overrule the action or decision of another|A manager is needed to override the transaction if the clerk makes a mistake.|
Overrule|to make a decision that opposes or rejects someone else’s idea, opinion, or decision|The Supreme Court decided to overrule the states’ bans and allow same-sex marriage in the U.S.|
Oversaturated|soaked; holding more of something that can be absorbed|Because it has rained for two weeks straight, the fields are oversaturated with water.|
Overseas|located in an overseas country|While flying overseas, Lisa got a good view of both continents and the Pacific ocean.|
Overseas|across a sea to a foreign country; abroad|The latest figures show the numbers of overseas tourists are still falling.|
Oversee|to supervise, guide, review or direct the actions of a person or group|Gamekeepers oversee a hunting ground to see to the wildlife’s welfare and look for poachers.|
Overshadow|to cause something to seem less important or noticeable|I knew that I needed to study for my exam, but my growing stomach and hunger pangs seemed to overshadow everything else.|
Oversight|something that someone does by mistake, without seeing that they are doing it|Rob apologized for the oversight, insisting that it was a mistake that would never happen again.|
Overstatement|an exaggeration or overemphasis|The president’s latest overstatement is just another example of his tendency to exaggerate.|
Overt|open and not secret|In some countries, racial prejudice is overt and not disguised in the least.|
Overtake|to take control of something|Rebels are entering the land and will try to overtake the government by force.|
Overtake|to pass a more slowly object|As the driver of a car tried to overtake a tractor trailer on a busy highway, he couldn’t complete the pass and moved back behind him.|
Overthrow|a removal of a figure or establishment from power|In order to overthrow someone in a position of authority, you will need enough power or support to remove them from power.|
Overtly|publicly, openly|It is important to read through contracts before you sign them because some things are not overtly stated.|
Overtone|something suggested but not directly stated|The rude email wasn’t directly racist, but it had a bigoted overtone.|
Overture|a piece of music played at the beginning of an opera or musical play|When he heard the overture begin to play, the actor immediately became nervous.|
Overview|a general review or summation of something|Because we needed to get the plan down quickly, our leader gave us a quick overview instead of a detailed plan.|
Overweening|arrogant; conceited|Ever since Jim won the contest, he has been overweening and acting as though he is the smartest kid on the planet.|
Overweight|weighing more than considered normal or allowed|The overweight patient came to her doctor for advice on how to lose at least fifty pounds.|
Overwhelm|to overpower in thought or emotion|A major test, a research project, and three assignments due tomorrow would overwhelm all the students with the amount of time and energy it would take to prepare for all of those tasks.|
Overwhelming|very intense or overpowering|An overwhelming sense of fear overcame the woman as she took a shortcut through a dark alley on her way home.|
Overwrought|in a state of excessive nervousness, excitement, or anger|The bride was overwrought when the florist delivered the wrong flower order.|
Overzealous|too enthusiastic, determined|The defense worried that the judge would be influenced by the overzealous prosecutor.|
Owe|to need to pay or give someone something|Because I don’t owe any money to anyone this week, I can spend my paycheck on what I want.|
Owe|to be indebted to the amount of|Paula said to Ben, “We only owe $900 on our car and we need to pay it off when we receive our tax refund.”|
Ownership|having legal possession of or being the owner of something|The title was given to the man after buying his truck so that he could prove ownership if needed.|
Oxen|typically male bovine trained as draft animals and beasts of burden|A pair of oxen are used to pull the farm cart that we own, since it is far too heavy to be carried with less powerful beasts.|
Oxidation|the result of a substance coming into contact with oxygen, generating a deficit of electrons|During oxidation, the oxygen caused the paint to peel off the metal rod.|
Oxidize|to merge with oxygen such as in the process of rusting or burning|If you leave your bike in the rain, it will oxidize and begin to rust.|
Oxygen|is a nonflammable gas with no smell or color|Mountain climbers often carry oxygen bottles on high altitude climbs to prevent hypoxia, a rapid condition which weakens your body.|
Oxymoron|an expression that contains words with opposite meanings|Normally, an oxymoron consists of a noun and an adjective which clashes in opposition with that noun.|
Ozone|the type of oxygen located in a high tier of the Earth’s atmosphere|Without the ozone layer, life will cease to exist on Earth.|
Pabulum|bland intellectual fare|I hate when presidential candidates mouth politically correct pabulum that they don’t even believe in.|
Pace|speed or rate at which one is moving|Moving at a snail’s pace, the writer didn’t think she would ever finish drafting the article.|
Pachyderm|a mammal, usually with thick skin, that has hooves or appendages similar in shape to hooves|If a circus has an elephant, it has a pachyderm.|
Pacific|calm, peaceful|The burglar was able to escape with many valuables because the homeowner's dog was very pacific.|
Pacifist|one who loves, supports, or favors peace over violence|Since he was a pacifist, he was hoping not to be drafted into the Armed Forces.|
Pacify|to placate or appease|If my husband thinks he can pacify me with a pearl necklace, then he is in for a big surprise!|
Packet|a small parcel or package|The patient returned the packet of papers to the doctor’s secretary once he filled them out.|
Pact|a formal agreement|Not wanting to forget the good times they had, the high school friends made a pact to keep in touch after graduation.|
Pad|flattened mass of anything soft|Mason put a rubber pad on the floor during his cardio class to reduce the pressure on his knees.|
Paddle|a small racket|Picking up the paddle and ball, the young child was ready to play her first game of table tennis.|
Paean|any loud and joyous song; a song of victory or achievement|After losing the game, the team was disappointed not to sing their victory paean.|
Pagan|an individual who doesn’t follow one of the world’s main religions|My uncle is a pagan who worships money.|
Pageant|a demonstration of contestants or incidents usually involving a common theme|As the women donned their native country’s costume, they walked across the stage in the Miss Universe Pageant.|
Paging|calling a person over a loudspeaker, usually in a public place|The store manager began paging for the customer to come to the front several minutes ago.|
Paging|calling out the name of a person over a loudspeaker|While someone was paging for the lost boy to come to the front of the store, his parents were having a meltdown.|
Pagoda|a pyramid-shaped religious building with curled up edges on each level that is usually found in Asia|During my visit to Japan, I noticed the pagoda towering over the tourists on the ground.|
Pail|a round container with a handle used for carrying things|When the barn caught on fire, the only thing pioneers could use to put the fire out was a pail of water.|
Pain|anguish and discomfort|When the child accidentally placed her hand on the hot stove, the pain could be heard in her screams and cries.|
Painful|experiencing or providing agony or discomfort|The painful bee sting resulted in my arm reddening and swelling to twice its original size.|
Painless|without pain or trouble|Thanks to the anesthesia, the surgery was painless for Shirley.|
Painstaking|performed with a great deal of attention|Even though the rebuilding of the old farmhouse was going to be a painstaking job, I could not wait to begin work on my new home.|
Paint|nan|The artist used different colored paint to make a colorful landscape of the sunset.|
Pair|a couple of things that work jointly|After putting on my clothes, I grabbed my pair of shoes and placed them on my feet before heading out the door.|
Palace|an estate with a large exquisite house or structure|Since the Tort Palace had a long history during the 1800s, it became a historical landmark that was visited by many tourists.|
Paladin|a very brave knight that fought using a horse and a sword|While fighting bravely for his country, Charlemagne’s paladin refused to bow down to any other knight.|
Palatable|satisfactory; suitable|Although the food is not the tastiest I have ever eaten, it is palatable and will fill my tummy.|
Palate|person’s sense of taste or appetite|Because she has a picky palate, the toddler refuses to eat anything other than chicken nuggets.|
Palatial|on a large scale with elaborate furnishings|The palatial diamond ring was so heavy it made Gina’s finger hurt.|
Palaver|unnecessary talk that wastes time|Although we were supposed to have a lecture, the teacher spent the entire period with palaver about his vacation.|
Pale|light in color|When I looked at my friend with the pale face and wide eyes, I realized she had also heard someone break into our house.|
Paleolithic|a period of time during the Stone Age where many stone and bone artifacts have been discovered|As the historian walked into the old cave, he took notice of the Paleolithic cave paintings depicting people and stones.|
Paleontology|the area of science which focuses on the past through the review of plant and animal fossils|Students with an interest in fossils should consider paleontology as a college major.|
Palette|an artist’s flat paint panel which is used for mixing and holding paint|Bob Ross usually used a dull knife to scrape the paint from his palette and smear it onto his canvas.|
Palimpsest|a thing which displays evidence of the alteration it has experienced|While the tradition has changed over time, it is still a palimpsest of our family’s history.|
Palindrome|a term or group of words that contain the same letters no matter which way the word is read|Since I knew my word during the Spelling Bee was a palindrome, I could easily spell it since I knew how to spell the first five letters of the word.|
Palisade|posts usually made out of wood that form a fenced-in area|As news of the Union troops marching closer to their town, the citizens built a palisade around their houses in order to defend themselves if troops attacked.|
Palladium|a platinum type metal that is a light silvery color and is flexible enough to be shaped|Due to its mobility, the electrical engineer used palladium to form it into the necessary shape so that it could be used as part in the electronic device.|
Pallet|a movable stand used for packing and transporting goods|When the 18-wheeler truck stopped by the company’s loading dock, each shipping pallet was loaded onto the truck.|
Palliate|to get rid of or alleviate|After surgery, Greg received large does of medications to palliate his suffering.|
Palliative|soothing remedy to relieve pain such as medicine|My rash needs some palliative lotion if it is going to stop hurting and heal.|
Pallid|pale skin or lacking in vitality or interest|Although she is a redhead with very fair skin, Maureen has tried all sorts of ways to give her pallid complexion just a touch of color.|
Pallor|an unhealthy pale appearance|After working on the project for four months, Carl was anxious to take a cruise in the sun and work on getting rid of his office pallor.|
Palpable|capable of being touched, felt, handled, or perceived| When she is angry at dinner, my mother kills the flavor of the meal with her palpable silence.|
Palpitate|to thump or throb intensely|When the music at the concert started to palpitate, it caused my head to hurt.|
Paltry|small or meager|My teenage son often complains about what he considers to be a paltry allowance.|
Pampas|treeless plains in South America|The pampas is extremely hot because the treeless terrain is under the equator.|
Pamper|to indulge with affection and attention|The gentleman would pamper his wife with a shoulder massage on a consistent basis.|
Pamphlet|a small booklet or leaflet of printed informational matter|Flipping through her pamphlet, Anna now felt she had a better understanding of the importance of recycling.|
Pan|a metal or iron pan used for cooking|Cover and slow cook the brisket in the large roasting pan for six hours at 275 degrees.|
Panacea|something that will make everything about a situation better|Unfortunately there is no panacea that will make cancer instantly vanish from your body.|
Panache|a showy self-assured manner or style|Because the band played with such panache, everyone in the audience had a great time.|
Pancreas|an organ that creates insulin and aids in digestion|As the anatomy instructor pointed out the pancreas from the lower half of the body’s diagram, the students noticed its distinctive shape.|
Pandemic|an illness or disease happening over a broad area|I have no interest in watching a television show about a pathological pandemic that turns half the world’s population into zombies.|
Pandemonium|chaos and utter craziness|Even though the teacher had instructed the children to be on their best behavior, pandemonium broke loose the minute Santa Claus walked through the door.|
Pandiculation|yawning and stretching|Before my feet hit the floor, my typical morning pandiculation process of yawning began.|
Pane|a piece of glass used in windows|When the baseball crashed through the pane, the father explained to his son how important it is to hit the ball away from the house.|
Panegyric|a speech or written composition used to pay tribute to a person, place, or thing|After the princess died a popular singer wrote a panegyric to honor her life.|
Panel|a thin section of a plank of wood|After piecing the panel together with the large headboard, the designer painted it and set it behind the bed.|
Pang|an abrupt yet intense spasm of distress or pain|When the bullet entered Rick’s stomach, it sent a pang of agony through his body.|
Pangaea|the name of the ancient super-continent that incorporated all of the earth|Pangaea existed when all of the Earth’s continents were one big continent.|
Panic|a quick worry or dread that someone can’t stop|Everyone could hear the panic in the child’s voice and see the strained look in his face as the boy searched for his mother.|
Panicky|having the qualities of a quick worry or dread that someone can’t stop|After unearthing a true scandalous story of her opponent, the panicky candidate began mumbling and fumbling around on stage.|
Panoply|an impressive collection or exhibition|The designer’s exciting panoply of dresses won over the fashion critics.|
Panoptic|showing or seeing the whole at one view|The panoptic view from the hot air balloon allowed us to see all of the city.|
Panorama|a picture of a long scene or place|Hot air balloon tours allow risk-takers to see a panorama of the city below while being thousands of feet up in the air.|
Panoramic|having the qualities of a long scene or place in a picture|As my friend showed me his panoramic photo of the mountain, I could point out the entire mountain system and all of the valleys.|
Pansophy|knowing all information|Studying theology allowed the students to ascertain that God’s pansophy enabled believers to put their faith in him.|
Pantheism|belief that God is the universe and the universe is God|Individuals who believe in pantheism maintain that God and the universe are the same being.|
Pantheon|a temple dedicated to all the gods|As part of their course, the mythology students visited the pantheon in the ancient city.|
Pantomime|the act of using gestures or movements instead of words to convey a message|After being given a word related to birds, the performer acted out a pantomime in which he ran around the room flapping his arms.|
Papacy|the period of time in which a pope is in office|St. Peter’s 35 year papacy was the longest of any pope in history.|
Paper|a thin flimsy item that is made from wood and mainly used for people to write on|After the little girl cut out the dolls and clothes from the paper, she folded the flaps of the paper dress onto the doll.|
Paperweight|a small, heavy object that is used to keep loose papers in place|Because he had no paperweight to hold down his files, the wind blew the attorney’s papers all around.|
Papist|a derogatory term that refers to a Roman Catholic who accepts the Pope as an authority of God|Pledging his allegiance to the Pope and the Catholic Church, the papist refused to acknowledge the Church of England.|
Papyrus|a material similar to paper made from the papyrus plant|The ancient document was written on delicate papyrus, and needed to be handled carefully.|
Parable|a short story that delivers a message|The play is a parable that teaches the students a lesson about the importance of being kind.|
Parabola|the kind of curve or arc that is created when an item is tossed upwards and lands in a different location|The curve of a parabola is created by the path an object takes when it ascends and then comes down in a different place.|
Parachute|a device made of fabric canopy that is used to slow the descent of a person or object falling through the air|The automatic parachute opener functioned properly, allowing the man to safely descend to the ground.|
Parade|organized procession consisting of displays, performances, exhibits, etc. displayed by moving down a street past a crowd|Henry took his kids downtown to the Christmas parade to see Santa go by on a float.|
Paradigm|a typical example or model of something|Sister Mary Catherine is considered a paradigm of virtue by everyone in the church.|
Paradigmatic|associated with a standard model or example|If you want to see a paradigmatic icon of music, you should attend Sir Elton's concert.|
Paradise|a very pleasant place|The dog was in his paradise whenever his owner took him to the dog park.|
Paradisiacal|pertaining to wonderland or a wonderful place; nirvana|I dreamed that I sailed to a paradisiacal island where I was fed gourmet food and played all the time.|
Paradox|a person, thing, or situation that is strange because they have features or qualities that do not normally exist together|In a strange paradox, the medicine made Heather sick before it made her better.|
Paradoxically|in a manner that is contradictory|Paradoxically, the economy is improving although many families complain about the poverty in which they live.|
Paragon|a model of excellence or perfection|As a paragon of purity, a nun would never dress inappropriately.|
Paragraph|sentences written one after the other about one topic|The English teacher assigned her 2nd grade students to write a paragraph about their summer vacation.|
Parallax|the impression that the direction or location of an object appears to vary when observed from diverse viewpoints|Because of the concept of parallax, locations look different when viewed at unique angles.|
Parallel|stretching on in the same way or path|Ms. Peterson realized that she was one street off from the doctor’s office, so she knew she could cut through to the next parallel street in order to reach her destination.|
Parallelogram|a flat shape with two pairs of parallel sides|The 10 by 20 rectangular cotton field formed a parallelogram.|
Paralysis|the lack of mobility in a limb or part of the body|Money from a grant issued wheelchairs to victims of the disaster who suffered from paralysis.|
Paralyze|to cause a person or part of the body to lose the ability to feel and move|A broken vertebra in her neck threatened to sever her spinal cord and paralyze her from moving.|
Paramedic|a person trained to respond to medical emergencies|Averaging around six minutes to respond to an emergency, the paramedic felt that his crew was efficient.|
Paramount|of the greatest concern|It is paramount that my grandfather takes his medicine if he wants to feel better.|
Paranoia|an illogical belief that others are against you|Jake kept his money under his mattress because of his paranoia about crooked bankers.|
Paranormal|supernatural events that cannot be explained by science|His love for ghosts led the new author to writing a mystery novel with a paranormal twist.|
Parapet|a wall located near the ground that protects the border of a roof, bridge, or other raised area|The parapet on the roof prevented the attacking soldiers from hitting the men who hid behind it.|
Paraphernalia|an assortment of items that are required for a specific task or activity|Inside of the supremacist’s camp, authorities stumbled upon a great deal of anti-government paraphernalia.|
Paraphrase|to take someone else’s words or writing and restate it|When you paraphrase the work, make sure that you clarify any confusing parts.|
Paraplegic|someone who is unable to move their legs and lower body|Due to the man’s broken back, the surgeon was certain the man would be a paraplegic for life since he couldn’t move his legs.|
Parasite|a living organism which exists by taking from another living creature, usually while living inside or on the host|The flea is a parasite that survives by extracting nourishment from other organisms.|
Parasitical|of, pertaining to, or having the characteristics of a parasite; leechlike or freeloading|Ticks feed off of human blood, making them parasitical and dangerous.|
Parasitism|an unhealthy relationship in which a parasite lives off another organism, usually causing damage in the process|Parasitism is a one-sided biological relationship in which an organism weakens a host while obtaining resources from it.|
Parasol|a lightweight umbrella used to block the sun|Hiding from the Kentucky Derby heat, the toffee-nosed lady shaded herself with a parasol.|
Parcel|an item wrapped or placed in a container so it can be transported|I am taking the parcel to the post office to be mailed.|
Parch|to dry up due to heat|With the sun shining so brightly, it was not difficult to parch the wet clothing.|
Parched|having a strong need for moisture|After being stuck in the desert for two days, I was parched and in need of water.|
Parchment|stiff, translucent paper that is used for baking or writing|Thin parchment paper lined the bottom of the greased baking pan.|
Pardon|to overlook or accept someone’s wrongdoing or an action|“Please pardon our interruption, but the boys’ soccer team needs to report to the gym immediately,” the principal said over the intercom.|
Pare|clip, tidy up or peel something to make it look better|In order to make my small apartment more comfortable, I had to pare down my possessions to only a few small pieces of furniture.|
Parenthood|the status of being a mother or father|After the 20-year old gave birth to her daughter, she realized that her party life was over since she entered parenthood.|
Pariah|one who is or should be excluded|When the child molester was released from prison, he was treated like a pariah in his community.|
Parish|the area under the guidance of a minister or priest|After a while, the priest left his congregation in the city to care for the souls in a small rural parish.|
Parishioner|an individual who is a member of a certain church congregation|As a parishioner of the First Baptist Church, my grandmother hasn’t missed a Sunday service in twenty years.|
Park|a plot of land in a natural surrounding for people to appreciate|Pokémon Go is a great game that encourages people to exercise by walking around in a park or down a street.|
Parlance|a way of speaking that is typical of a certain group or culture|When I heard the computer programmers talking about coding, I could not understand a word of their parlance.|
Parlay|to place a wager on an upcoming event|During March Madness, many gamblers parlay their earnings on the basketball teams that they think will win the tournament.|
Parley| conversation between enemies or rivals|The end result of the parley between the two world leaders was a productive trade agreement.|
Parliamentary|pertaining to a government or lawmaking group|Once the candidate won the parliamentary election in Great Britain, he knew he would first change the law about child abuse victims.|
Parlor|a nice room in the house that is reserved for socializing with friends|As the pastor and his wife were escorted into our parlor to discuss our membership in the church, I quickly got my husband to join us.|
Parlous|unsafe; risky|Because of the storm, it was parlous for the children to leave school.|
Parochial|having a restricted outlook|John’s view of life is parochial and does not include anything outside of his own happiness.|
Parody|a humorous impression of a creative work|When I heard the parody of the love song, I could not stop laughing.|
Parole|conditional release of a person convicted of a crime|The convicted killer had no chance of parole, but was spared from the death penalty.|
Paroxysm|an unexpected outburst of emotion|Since Jason is normally quiet, he shocked everyone when he made a loud paroxysm in response to being fired.|
Parricide|the murder of a parental figure or close relative|Because the number of teens killing their parents has recently increased, researchers have started to delve further into the issue of parricide.|
Parry|a shielding or defensive maneuver used for protection|She put on her sunglasses to parry his probing eyes.|
Parse|deconstruct a sentence or word and explain its parts|In order to diagram sentences, the students were required to parse the sentence into the correct parts of speech.|
Parsimonious|the quality of being careful with money or resources|To save money, the parsimonious old man always bought used clothes.|
Parson|a Protestant clergyman that is over a parish church|The parson felt it was his responsibility to protect and defend the rights of the church.|
Parsonage|a house provided by the church for a clergyman|The priest lived in a spacious parsonage not far from his church.|
Part|a piece or section of something|Most of the cake was eaten at dinner, but a part of it was wrapped and saved for tomorrow.|
Partake|to take part in an activity; to participate|I will not partake of your party because it attracts a lot of criminals.|
Partaker|a person who joins in or takes part in an activity|Each partaker of the Sunday meal is expected to bring a dish to share with others at the dinner.|
Partial|part of the whole; incomplete|Our boss rejected the proposed plan because he claimed that it was only a partial solution to the problem.|
Partiality|prejudice is shown towards something|Ms. Frost showed her partiality towards her smart students by refusing to call on anyone in her class who didn’t have an A.|
Partially|somewhat or relatively done|Once both boys were caught accidentally smashing the window with a rock, Bill was only partially responsible for the damage because the other boy should pay too.|
Participant|one who takes part in an activity|Each participant will be given a name tag to show that they paid to come to the conference.|
Participate|to join in, to take part, to involve oneself|“Will you participate in the three-legged race or the sack race?” Shirley asked her best friend.|
Participate|to join in or take part in something|Several people have signed up to participate in the local kickball game.|
Participation|contributing and being involved in something|As the new treasurer in the student council, Tiffany’s participation in student government would look good on her college applications.|
Participatory|sharing or taking part in something|After requiring the teachers to meet together to discuss their lesson plans, the participatory meeting allowed everyone to become involved in the curriculum.|
Participle|a word formed from a verb that functions as an adjective|In the sentence “The man was happy to see the rising sun,” rising serves as a participle.|
Particle|a small git or speck|A gust of wind blew a small but irritating particle of dust into my eye.|
Particular|certain or distinct|The children paid particular attention when the teacher began explaining what would be on the next big exam.|
Particularly|to a higher degree than normal or average|The veterinarian likes all animals, but she is particularly fond of rabbits.|
Particulate|a very small piece or particle|Although the elements are small, particulate pollution can cause a great deal of damage to the environment.|
Partisan|prejudiced in favor of a particular cause|Because of your partisan views, you are unwilling to look at other options.|
Partition|a divider that breaks up an area|We will use a partition to divide our living area into a living space and a workspace.|
Partly|somewhat or moderately|With some sun shining through the clouds, the weatherman stated, “it is partly cloudy today.”|
Partner|a couple or duo who worked together during an endeavor|Tiffany wanted an experienced business partner to help her begin her beauty shop business because they could make it a success.|
Partnership|the act of being together with one other person, entity or thing|In order to play the game, the students were in a partnership competing against the other teams for the prize.|
Parturient|in labor; in the process of giving birth|The parturient mother hoped that her labor would end quickly and without much discomfort.|
Parturition|childbirth; the process of giving birth|Breastfeeding can continue several years after parturition is complete and the baby is born.|
Party|a group of people who come together for a celebration|When Karen walked into the dark room, she realized it was her surprise birthday party as soon as the lights came on.|
Parvenu|an individual who moves from a lower economic and social class to a higher one while remaining an outsider|To the town's oldest and wealthiest families, the lottery winner was a parvenu who would never be welcome in their social circle.|
Pasquinade|a composition (cartoon, flyer or skit) that imitates, mocks or misrepresents somebody's style, typically in a humorous way|The politician was unamused at the latest pasquinade published in the newspaper.|
Pass|to go or move forward or through|We waited a long time at the railroad tracks for a train to pass through.|
Passage|a route for something to go through|Christopher Columbus believed he found a passage to India but instead he found a new land.|
Passenger|a person who is riding in a vehicle|Only one passenger in the train was killed, but several others were injured when the train derailed.|
Passerby|a person who happens to be walking by something|Thankfully, a passerby spotted the raging fire and called 911.|
Passerby|one who passes by someone or something by chance|The police officer stated that a passerby noticed a damaged empty vehicle in a ditch and reported it.|
Passion|an intense liking and desire for something|Even though most of the man’s friends called him cheap, he just had a strong passion to save as much money as he could.|
Passionate|strong feelings toward something|After suffering from two bouts of cancer, the family became passionate about donating every year to their local cancer organization.|
Passionately|to be done with great feeling and reaction|After acquiring her great singing gig, Annette sang passionately to the large audience in the Grand Theater.|
Passive|undertaking no action|The passive man never placed a hand on his abusive wife.|
Passivity|the state of being passive, inactive, or lazy; a lack of initiative|Her passivity in making a decision led to her termination from work.|
Passover|a spring celebration in the Jewish faith due to their people gaining their freedom|Typically taking place in March or April, Jewish people commemorate the Passover holiday with a feast.|
Past|period of time that has already happened|I notified the grocery store manager about the milk I needed to purchase was past the expiration date.|
Paste|a substance that is thick but moist and is usually made by mixing dry ingredients with a liquid|Mixing the flour with a bit of water, the chef created a thick paste to serve as the base of her recipe.|
Pasteurization|a purification process which uses heat to kill bacteria and germs|Milk is required to go through a pasteurization procedure so that it is fit to drink without getting sick.|
Pastiche| a mix of unique items|The mix of country, pop, and soul music made the album a fascinating pastiche of sounds.|
Pastime|a hobby done during someone’s free time|After Mr. Frank retired from his office job, his pastime included golfing, reading and traveling.|
Pastoral|pertaining to the country or to country folk|The Smiths decided it would be better to raise their family in a pastoral area outside of the city.|
Pasture|a grassy meadow of land used to grow grass or for livestock|Farmer Fred rarely needed to mow his pasture due to his cows always grazing the grass and keeping it short.|
Pat|to touch or tap something softly|“Pat yourself on the back for a job well done on the difficult test,” the teacher said to her class.|
Patch|to conceal and protect a little piece of cloth or other material over a gap|Mothers usually have to patch their little boys’ pants because they frequently play so rough outside with their friends.|
Pate|the uppermost part of a human being’s head|After falling from the third floor, the victim lay dead on the sidewalk since he landed on his pate damaging his brain.|
Patent|an official government document that allows the creator of a product to only create and sell this product for a period of time|After the consultation with a lawyer regarding my invention of a self-cleaning placemat, the lawyer explained that the patent would take years to acquire for my product.|
Patented|pertaining to a product, service or invention that has been issued a government document limiting others from reproducing it|Their patented cordless vacuum cleaner made millions of dollar for the Sands family since their company made the only cordless type.|
Patently|clearly so; without a doubt|Although the information was patently false, the naïve woman believed the lies anyway.|
Paternal|of or pertaining to one's father|Abigail’s paternal grandfather was born in Johnstown, Pennsylvania.|
Paternalism|a method of governance by which an authority advises individuals while not allowing them to make decisions|The principal’s paternalism is necessary because it limits the actions of rebellious students.|
Paternity|the condition of being a specific child’s father|A paternity test will determine if Bill or his best friend is the child’s dad.|
Path|a track or route|Looking left, the victim ran down a path that led out of the park with the attackers close behind her.|
Pathogen|a tiny organism that brings about a disease|The pathogen triggered an illness that made half the student body sick.|
Pathological|in an unusual or unhealthy manner|My sister is a pathological liar who never tells the truth about anything.|
Pathos|a feeling of sympathy or pity|The pathos of the movie caused me to leave the theater with tears in my eyes.|
Pathway|a trail or passageway|Nurse Johnson informed the cancer patient that the only pathway to recovery was through ten treatments of chemotherapy.|
Patience|tolerating and enduring frustrating, time-consuming and problems with ease and composure|Her patience was running thin as she was waiting four times longer than anybody else in the restaurant to be seated.|
Patient|tolerating problems or irritation in an easygoing way|When the truck seemed to be in an emergency, the patient driver of the car remained still for the truck to pass.|
Patiently|in a tolerant and good natured way|After spending three hours in the doctor’s waiting room, the woman still waited patiently for her appointment.|
Patina|a layer of coating|A shiny patina covers the statue, amplifying its historical value.|
Patio|a paved outside space that is usually attached to the house|During the garden party, the club members met on the patio to sip their lemonade and discuss the items on the meeting’s agenda.|
Patois|the accent and way that the people of a certain area speak that is different than the rest of the place|As the patois of the woman’s words were heard, many people couldn’t quite understand what she was saying.|
Patriarch|the male who sits at the head of the tribe or family|In my house, my father is the patriarch of the family.|
Patriarchal|related to a system that is run or ruled by men|Many ancient societies were patriarchal in nature, having predominantly male leaders in both the military and politics.|
Patriarchy|a system of authority in which males are the power holders|For over a hundred years the country has been ruled through the patriarchy of kings.|
Patrician|relating to an individual born into a lofty position or an aristocratic family|Marcus was born into a patrician family of great wealth.|
Patricide|the action taken when an individual ends the life of his or her father|Peter was arrested for patricide after killing his father.|
Patrilineal|pertaining to the father’s lineage|Since Patty was born to a single mother, she was unaware of her patrilineal health problems.|
Patrimony|property or goods passed from one’s father or predecessors|The antique is part of the patrimony I inherited from my daddy.|
Patriot|a person who shows allegiance to his or her country by supporting and defending it|When Great Britain raised the taxes, the patriot decided to fight the British and push for becoming our own nation.|
Patriotic|pertaining to one’s allegiance and dependability to one’s country|Every patriotic song in the tribute to the fallen soldiers was sung by a choir of professional singers.|
Patriotism|allegiance and dependability to a country|After 9/11 many U.S. citizens showed patriotism and supported the country by donating time and assistance to each other.|
Patrol|a duty to guard or observe an area for security reasons|As part of her family’s business, Melissa was required to do a nightly patrol on Fridays to ensure that nobody broke into their jewelry store.|
Patron|an individual who frequents a specific bar, eatery, or other company|I have a regular patron who eats meatloaf at the same time every day.|
Patronize|to give money or support to someone or something|I patronize my favorite restaurant at least twice a week.|
Patronymic|pertaining to the father’s or male relative’s name|After many arguments, the expecting couple finally decided to use a patronymic name which made her husband happy.|
Pattern|a decorative design or motif|The seamstress sewed an interesting pattern on the back of the model’s dress.|
Paucity|a small amount of something that is not enough|Because of the paucity of our oil supply, we need to seek out other fuel resources.|
Pause|to stop temporarily|Before giving his answer, the student had to pause and think for a moment.|
Pause|an act someone halts temporarily, usually from a task or speaking; short break|When the prosecutor asked the witness on the stand a complex question, there was a long pause before he answered.|
Pave|to overlay a surface usually with cement or concrete in order to make it easier to travel on|The interstate was down to one lane of traffic since the county decided to pave the rough road.|
Pavement|a smooth concrete surface|Since the cement had not dried yet, the pavement was roped off so no one would walk on it.|
Pavilion|a constructed shelter used for certain reasons|As the torrential downpour interrupted our picnic, the family sought shelter at the pavilion nearby.|
Pavonine|pertaining to a peacock|As the rain began to come down, the woman’s rainbow-colored umbrella lifted over her head with a pavonine effect.|
Paw|the appendage of a two or four-legged animal|When I noticed my cat moving her paw up and down on the sofa, I realized that she had torn a hole in the fabric.|
Pawn|an item that is handed over as collateral for a money loan|Since my engagement ring was so important to me, I decided to pawn it so that I could get it back in a few days.|
Pay|to give to a person what is due, as for goods and services|Barbara reminded her husband to pay the property tax soon or we will be charged a penalty.|
Paycheck|a check in payment of wages and salary|Jason received his first paycheck from his summer job and immediately went to the bank and cashed it.|
Payment|the amount paid or installment of something owed|I only owe one more payment on my car loan, and then my debt will be paid in full.|
Payroll|distinct amounts of money distributed to a list of workers for conducting their job|At the Bush Family Restaurant, payroll required the owners to issue a check to each member of her wait staff for minimum wage.|
Paystub|a piece of paper given to a worker that shows the amount of money he or she earned and what was taken for taxes|Without a paystub to show the actual numbers, the employee couldn’t be sure what was being taken out for taxes.|
Peace|harmony and restfulness|It was peace of mind knowing that all of my bills are paid this month, and I will begin working full-time next month.|
Peaceable|tending to be free from disagreement and fighting|During the riots, a girl handed over a flower to one of the armed policemen as a peaceable gesture towards the enemy.|
Peaceful|without disruption, commotion or disorder|Since my mother was babysitting the newborn and my husband was out of town, I actually had a peaceful sleep tonight.|
Peacefully|quietly and calmly|Martin Luther King Jr. marched peacefully to the Lincoln Memorial and gave his “I Have a Dream” speech.|
Peak|the highest part of a mountain|The view from the balcony was impressive as the homeowners could see snow covering the peak of Mount Finley.|
Peal|the piercing sound of something|As I walked down the street on the June day, I could hear the peal of the wedding bells coming from the corner church.|
Pear|a sweet firm fruit that has a thinner top with a bowl-like base|Chef Henry cut up a pear, banana, apple and peach so that he could make a fruit salad for the guests.|
Peasant|an individual of the lowest class who is normally uneducated|The peasant signed his name with an “X” because he couldn’t write anything else.|
Peat|remnants of vegetables that are used to enrich soil|Once the gardener spread peat into the clay dirt, it only took a matter of days before the plants began to grow.|
Pebble|a flat stone|As a game, I would throw a pebble at an angle to the lake to see how many times it would skip across the lake.|
Peccable|likely to do wicked or wrong things|Judge Smith already knew the peccable ways of the defendant since he had been before the judge over twenty times.|
Peccadillo|a small mistake or fault|Because Josh had grown tired of Patty’s criticism of every little peccadillo, he asked her for a divorce.|
Peccant|having committed a sin|The peccant man shared his sins with his priest.|
Peck|to jab or poke at something|Since the bird’s eggs were in the same tree with the snake, the mother bird continued to peck at the snake.|
Peculate|to take money that belongs to others, usually a business or public agency|Because Adam needed money to pay his bills, it was hard for him to fight the temptation to peculate funds from the bank.|
Peculiar|odd; unusual|My uncle is a peculiar man who wears the same outfit several days a week.|
Peculiarity|having an odd or strange way or action|Wearing a wide-brimmed red hat and a bright flowery outfit, the peculiarity of the woman caught everyone’s attention.|
Pecuniary|dealing with finances|Because of the young woman’s pecuniary needs, she is determined to marry a wealthy man.|
Pedagogy|activities of educating, teaching or instructing|The school boasts the most progressive pedagogy and a 100% graduation rate.|
Pedal|to move a bicycle by operating the controls|In Germany, many people pedal to work and school because the bicycle is the common way of transportation.|
Pedant|a scholar or learned person|After answering every question the teacher asked, the pedant drew attention to himself in front of the other students.|
Pedantic|giving too much importance to details and formal rules|Sometimes, Jason is so pedantic in writing the perfect paper that he forgets to properly manage his time.|
Peddle|to sell products by traveling to other places|In order to peddle his wares, the young man went door to door describing each product as best as he could.|
Peddler|an individual who moves from location to location selling things|As a teenager, I worked as a peddler selling magazines door-to-door.|
Pedestal|a standing from which an individual is greatly admired|Even though you put the rapper on a pedestal for making the occasional charitable donation, the man is really just a thug.|
Pedestrian|uninteresting or boring|A large number of people fell asleep during the pedestrian play.|
Pedigree|a record of ancestry that relates to living creatures|The dog’s pedigree identifies his parents as two purebreds.|
Pedometer|a device used to measure steps taken|The track coach used the pedometer to measure how many strides we took in the race.|
Peek-a-boo|something that just reveals glimpses of something while hiding the rest|The peek-a-boo windows only offered a small glimpse of the gorgeous mountains outside.|
Peek|to take a quick glance|Sara took a peek inside the cookie jar to see if there were any cookies left.|
Peep|to look|Take a peep inside the treasure chest to see what prizes you could earn for good behavior.|
Peer|is an equal person of the same age|Have a peer that sits close to you in class check your essay for mistakes before you turn it in.|
Peerless|one and only; superior than any other|The peerless boxer never loses a fight.|
Peeve|an annoyance or irritant|Making a tapping sound on the desk was the peeve that annoyed our teacher the most.|
Pejorative|expressing disapproval or belittling the importance of something|While the detective was supposed to be neutral, he described the suspect in a pejorative manner.|
Pelf|money|The penny-pincher refused to part with any of his pelf, choosing to only spend on things that were absolutely necessary.|
Pell-mell|a confused or disorderly manner|The crowd of people was running about in an absolute pell-mell that was difficult for the riot police to keep under control.|
Pellucid|very well-defined in meaning and style|The contract was pellucid and left no confusion about each party’s responsibilities.|
Pelt|to beat or hit repeatedly|When I looked up at the tree, a squirrel took an acorn and acted like it would pelt me with it.|
Penal|penal refers to a disciplinary punishment|Using that drug outdoors is a penal offense, but using it indoors is permissible.|
Penalty|a penalty is punishment for violating a rule or law|The player caused the team to receive a five-yard penalty for unsportsmanlike conduct.|
Penance|self-inflicted punishment for a misdeed|The priest told me to say twenty Hail Marys as a penance for my sins.|
Penchant|a strong liking|At an early age, my annoying brother seemed to have a penchant for getting into trouble.|
Pendant|a pendant a piece of jewelry worn around the neck|The teenager had a rose gold pendant around her neck with a chain that hung low.|
Pending|pending means awaiting approval or decision|The payment I made on the car note is pending, but it hasn’t gone through yet.|
Pendulous|hanging down|Due to the pendulous flaps on the oversized tablecloth, the cat would claw at it.|
Pendulum|something hanging and swinging freely back and forth under the influence of gravity|When the pendulum clock strikes twelve, it produces a heavy clanging.|
Penetralia|penetralia is a centermost hidden chamber or room|The penetralia of the mysterious pyramid was a hidden chamber completely made of gold.|
Penetrate|to blend into a group or organization or to gain entry|A bullet can easily penetrate your skin.|
Penetrated|penetrated means to go through|The doctor’s scalpel penetrated the patient’s skin as he began the autopsy.|
Peninsula|a peninsula is a piece of land surrounded by water|We took a trip to the peninsula which was surrounded by water on all three sides.|
Penitent|feeling grief for a previous offense or sin|The penitent husband spends days at his wife’s grave because he regrets not spending more time with her.|
Penitentiary|an area where individuals who have committed major crimes are imprisoned|My brother is a guard inside of a penitentiary that houses traitors, military spies, and the like.|
Penmanship|penmanship is handwriting|Calligraphy refers to a distinct sophisticated style of penmanship.|
Penniless|penniless means without money and extremely poor|We saw a penniless homeless man holding a sign that said, “Will work for food”.|
Pensee|a pensee is a thought, or thoughts, translated into a literary format such as prose or poems|No one was surprised that the author wrote an entire book with nothing but one single idea or pensee inside.|
Pension|a payment made during a person’s retirement|I will receive far less pay in my retirement pension plan, but poor health won’t allow me to keep working.|
Pensioner|a person who receives a pension|Alice became a pensioner upon her retirement, and she is waiting to receive her income.|
Pensive|expressing or revealing sad thoughtfulness|Unrequited love caused her to be in a very pensive mood.|
Pentacle|a symbol of a circle with a star inside of it|With its five pointed shape, Tara took the pentacle and placed a chain through the round outer shape to make it a necklace.|
Pentagon|a figure with five straight sides and angles|At first I didn’t recognize the shape, but then I remembered it was a pentagon because it had five sides.|
Pentecost|the celebration of the day the church began|The Pentecost is the religious festival celebrated on the seventh Sunday after Easter.|
Penultimate|right before the final one|The author should have ended the series with the penultimate novel instead of closing out the hero’s tale with this poorly written story.|
Penumbra|something that conceals, encloses, or cloaks something else|A penumbra of snow covered the city during the blizzard.|
Penurious|desperately in need; not having enough|The penurious little boy could not afford to buy school lunch.|
Penury|extreme poverty|My uncle wasted his fortune and died in penury.|
Peppy|energetic and high-spirited|The cheerleader was overly peppy at the football game in an effort to pump up the crowd.|
Peradventure|doubt or uncertainty|Her peradventure about the exam made her doubt her ability on standardized tests.|
Perambulate|to travel over, especially on foot|They decided to take a short cut and perambulate over the large hill.|
Perambulator|a stroller|The baby was being pushed in the stroller-like perambulator on a sunny day.|
Perceive|to view or become aware of|Sometimes I am so concerned about how others perceive me that I do not always listen to my own voice.|
Percentage|an amount in each hundred|The percentage of the high school dropout rate has decreased from 22 percent to 14 percent.|
Percentile|a certain percentage of a whole, usually on a scale of 100|Because the overweight toddler is in the 99th weight percentile, his doctor suggested diet changes.|
Perceptible|able to be noted or observed|She spoke softly, and her words were barely perceptible.|
Perception|a way of understanding or regarding a particular subject|Your perception of the world around you is dictated primarily by your five senses, and how you understand the world changes drastically if you are lacking one of them.|
Perceptive|very aware and sensitive to events around them|As the experienced shoplifter swiped a necklace from the open case in the jewelry store, the perceptive owner of the store realized what he did.|
Perceptively|showing insight and intelligence through action|The wise doctor perceptively diagnosed the patient without expensive tests.|
Perceptual|the ability to interpret and perceive|Perceptual learning relies on students’ sensory systems to naturally draw conclusions.|
Perch|to settle or land on a raised area or site|The birds commonly perch on the strong cable wire before diving down to the ground below.|
Perch|to sit and rest|Birds sit and perch in their cages at the pet store.|
Perchance|perhaps; by chance|If we were more self-confident, perchance we would feel better about ourselves.|
Percipient|to have a good perspective of things|He was percipient to the novel because he understood the plot from start to finish.|
Percolate|to gradually penetrate|During the gas leak, the fumes seemed to percolate the entire house.|
Percussion|an instrument that makes music when struck|Of all the instruments, the drums were the highlight of the band’s percussion performance.|
Peremptory|used to describe an order, command, etc., that you must obey without any questions or excuses|In a peremptory tone, the flight attendant told the passenger to either fasten his seatbelt or get off the plane.|
Perennial|lasting or remaining active throughout the year, or all the time|Every election seems to continue to deal with the same perennial issues that have been the focus of all the previous elections.|
Perfect|complete in all respects; flawless|The detail information given to the online recipes, gives me a perfect dish every time.|
Perfection|flawless or unblemished physically, mentally, and spiritually|Many see models as a symbol of physical perfection, but they have just as many flaws as the average person.|
Perfidious|not able to be trusted|When questioned about his ex-wife, Eric described her as a perfidious woman who could not be faithful to any man.|
Perfidy|behavior that shows that someone cannot be trusted|Because my husband’s perfidy hurt me terribly, I served him with divorce papers.|
Perforate|to pierce or penetrate and make holes in|If she would perforate the paper, she would be able to place it in her notebook rings.|
Perforce|because of circumstances or necessity|The paroled criminal must perforce obey the law or otherwise he will be imprisoned again.|
Perform|to carry out or fulfill a task|The doctor will perform an exam on the patient and report back with the results.|
Perform|to do a function or action|The new computer I have can perform an array of tasks my last one didn’t offer.|
Performance|an activity that a person or group does|The baseball player’s performance was a lot better this game than the last time he played.|
Perfunctory|done routinely and with little interest or care|The beauty queen waved so often that her greeting was simply perfunctory.|
Perigee|the point in the orbit of the moon or a satellite at which it is nearest to the earth|Because the moon is at its closest to the earth during perigee, the gravitational pull is stronger and tides increase.|
Peril|grave and imminent danger|Since your life is in peril, I suggest you run!|
Perilous|full of danger|Since the journey is perilous, be sure to bring a first-aid kit.|
Perimeter|the border of an area or figure|The fence around my house identifies the perimeter of my property.|
Period|the range of time when something happens|It was reported on the news that eight people were killed by gun violence over a period of three days.|
Periodic|occurring regularly or at specific intervals of time|The parole officer shows up at the woman’s home for periodic checks every month.|
Periodical|occasional or appearing at different intervals|Taking periodical breaks, the college freshman was able to finish his college paper in one night.|
Peripatetic|traveling from place to place|Rather than limit myself to one destination, I like to take a more peripatetic vacation where I move around from place to place.|
Peripheral|relating to minor matters|The boss is too concerned about peripheral issues that do not matter to notice our sales are at an all-time low.|
Periscope|a viewing instrument, in the shape of a tube comprised of mirrors and lenses, that allows a viewer to obtain a clear field of sight|Although the soldier was positioned in a ditch, he was able to use a periscope to observe the enemy camp above ground.|
Perish| pass away; rot or decay|Without enough lifejackets, someone might perish at sea.|
Peristalsis|rhythmic, wave-like contraction of the digestive tract that forces food through it|Muscular peristalsis helps keep food moving downward through wavelike contractions.|
Perjury|giving false testimony after swearing to state the truth|During his testimony, Jim committed perjury when he misled the court about his wife’s whereabouts.|
Perk|a bonus or incentive|Since the perk to working at the restaurant was the free meals, the young man decided to take this job.|
Perky|lively or enthusiastic|After drinking two cups of strong coffee and three espresso shots, Steven was so perky that he was doing cartwheels around his office.|
Permafrost|a soil layer, typically found in extremely cold regions, that remains frozen for a very long time|The cold temperature in the Arctic region keeps the permafrost frozen.|
Permanence|the state of being fixed or stable|The couple enjoy spending time together but know the relationship isn’t one of permanence.|
Permanent|something that will last indefinitely, cannot be changed, or erased|The location of your birth is permanent, as it is a fact that will never change no matter how old you get or where you go in life.|
Permeable|that absorbs or allows the passage of fluids or gases|The permeable material allowed a large amount of water to seep through.|
Permeate|to pass or spread through|When the skunk’s spray began to permeate the car, my sister and I jumped out the vehicle and ran down the road.|
Permissible|permitted|Jack hired a lawyer to fight his speeding ticket because he claims that he was driving at a permissible speed.|
Permissive|giving permission, or predisposed to give it; lenient|Timmy's mother was too permissive, allowing him to do what he wanted when he wanted.|
Permit|to give authorization to do something|My mother, in all of her graciousness, has decided to permit me to go to the party with my friends, even though my dad does not think I should.|
Permutation|one of the forms or conditions in which something occurs or can be positioned|In time, the bacteria will undergo a permutation that will make it unaffected by antibiotics.|
Pernicious|highly injurious or destructive|The pernicious cycle of abuse within their family must be stopped.|
Peroration|the conclusion of a speech designed to drive the message home|The President’s peroration was extremely passionate and heartfelt, reinforcing the message that we all had to stick together as a nation.|
Perpendicular|precisely upright or vertical at a ninety-degree angle|The cross is made of two wooden boards with one of them placed in a perpendicular position over the other one.|
Perpetual|continuing forever, constant, never-ending|The country is in a perpetual war, with no end in sight.|
Perpetuate|to cause to continue|If you yell at Jane after she yells at you, your actions will only perpetuate the argument.|
Perpetuity|forevermore or permanently|The greedy investor wanted to receive a royalty off the product in perpetuity.|
Perplex|to puzzle or confuse|According to the book reviewer, the author’s puzzling writing style will perplex many readers.|
Perplexity|a confused mental state|He was confused by her words so he stared at her in perplexity.|
Perquisite|a privilege, gain, or a special benefit; perk|Ronald considers his pension to be the most desirable perquisite of his profession.|
Persecute|to afflict constantly so as to injure or distress|The town tried to persecute a homeowner after they found out he was gay.|
Perseverance|resolve that allows one to continue with a duty or task regardless of difficulty or previous attempts|The disabled young man’s perseverance allowed him to complete the marathon.|
Persevere|to persist in completing a task or meeting a goal|If you want to achieve your goal, your must persevere despite all obstacles.|
Persimmon|a reddish-orange sweet fruit that is similar to a plum|After pulling a persimmon off the tree, the young girl took a bite into the juicy rosy produce tasting its sugary flesh.|
Persist|to strongly maintain or carry on|Once the detectives decided to persist with their interrogation for ten hours, the suspect finally confessed to the crime.|
Persistence|the ability to continue on with something in spite of difficulty or opposition|His persistence at practicing paid off when he made every free throw shot during the game.|
Persnickety|being overly focused on small details|The persnickety housewife couldn’t stand for anything to be out of place in her perfect home.|
Persona|the appearance one has around other people|Even though Jason is a kind kid, he wears the persona of a tough thug when he is with his friends.|
Personage|an important person; notable|He doesn’t look familiar, but he must be a very important personage to have a prominent spot in the photo shoot.|
Personal|something that only relates or applies to the person in question|Never put personal information like your home address, birthdate, or social security number on the internet.|
Personality|the attitude, temperament, and disposition of someone|Many people loved Cassie’s personality because she would always make you laugh with her wonderful sense of humor and kindness.|
Personalize|to customize something or tailor it to specific needs|The company was able to personalize my phone case by adding a picture and my initials to it.|
Personification|a thing or individual that embodies a specific quality|The queen was the personification of royalty as she waved from her coach.|
Personify|to give the qualities of a human being to a thing or concept|People often personify their cars by giving them human names.|
Personnel|employees or workforce of a company|All building personnel were evacuated after a gas leak occurred close to the home office.|
Perspective|the way an individual views something|After the near-fatal car accident, Sharon changed her perspective on life and decided to quit her job.|
Perspicacious|able to judge quickly and correctly what people and situations are really like|Even though the judge was normally a perspicacious woman, she found it hard to not be affected by the guilty man’s plea.|
Perspicacity|the ability to notice and understand things that are not obvious|The detective’s perspicacity allowed him to easily recognize the criminal in the crowd.|
Perspicuity|clearness that is easy to understand|Lack of perspicuity made the mayor’s speech confusing and bewildering.|
Perspicuous|easy to comprehend|Because my son needed to work on his reading comprehension skills, I bought him several perspicuous books.|
Perspiration|salty, watery fluid secreted by the sweat glands|Bob uses as much antiperspirant deodorant that he can, because he hates the feeling of perspiration trickling from his armpits.|
Persuade|to convince an individual or group to do something|If your friends try to persuade you to break the law, you should consider making new friends.|
Pert|well-formed; attractive|The baby has ten well-formed, pert little fingers and toes.|
Pertain|related or connected to the subject being referenced|The statistics found in the study pertain to the relationship between coffee drinking and poor sleep habits.|
Pertinacious|firm on achieving a task|The pertinacious girl would not stop trying to sell cookies to the toothless man.|
Pertinent|relevant to a particular matter|To ensure a prompt reply, please include all pertinent details in your email.|
Perturb|to upset a person|The troublesome lad does everything he can to perturb the girl sitting in front of him.|
Perturbation|the condition of being distressed|My mother’s perturbation was caused by my father’s sudden death.|
Perturbed|worried or disturbed by something|My coworker’s remarks about my figure perturbed me so I started to avoid him.|
Peruse|to read or examine carefully; to look over casually|Peruse the manual to set up your television.|
Pervade|to spread through all parts|The awful smell from the sewage plant seemed to pervade throughout our house.|
Pervasive|capable of affecting or influencing everything|The media’s pervasive coverage of the epidemic has most of the country living in fear.|
Perverse|not normal or proper|The serial killer found perverse pleasure in every murder he committed.|
Perversion|human behavior, especially that of a sexual nature, that isn’t considered normal or moral|The man’s perversion of the truth caused him to believe things that were abnormal were acceptable.|
Pervert|to distort or corrupt something|Dan’s jealous coworker tried to pervert his boss’s view of him, but the evil plan didn’t work.|
Pesky|irritating; annoying|Swatting at the pesky fly, Granny wished that she could kill the irritating creature once and for all.|
Pessimism|the habit of always seeing things in the worst light|Ruby’s pessimism convinced her she was too old to go back to school.|
Pessimistic|negative in outlook|Because Helen has a pessimistic attitude, she never believes anything good will happen to her.|
Pester|to bother someone with several questions or requests to the point that it becomes a point of anger|Brian hated when his annoying little cousin visited because he liked to pester him with a hundred questions.|
Pestiferous|carrying infection or disease|Because they are pestiferous, infected mosquitos can easily spread disease from area to area.|
Pestilence|a devastating illness or disease that causes a large number of individuals to die|When AIDS first emerged onto the scene, it was viewed as one of the worst cases of pestilence the world has ever seen.|
Pestilent|producing irritation|Because John has a pestilent personality, he annoys many of the kids in his class.|
Pestilential|capable of producing a devastating and contagious disease|The families in low-income housing were affected by a contagious illness caused by pestilential rodents.|
Pestle|handheld tool used to grind or crush substances up|In order to get the dog to take his medicine, the owner had to crush the pill with a pestle.|
Petal|one of the soft colored leafs surrounding the center of a flower|Due to its lack of water, each drooping petal fell from the plant’s stem onto the ground until the plant was bare.|
Petard|a small bomb that is used to breach a door or wall|The soldier through a petard at the entrance and waited for the bomb to blow before rushing inside.|
Petite|comparatively little or tiny|As the petite woman walked into the basement with the low ceiling, she certainly didn’t have to duck like everyone else.|
Petition|an official document that makes a request and is signed by supporters|A nonviolent way to protest a law is by signing a petition requesting the annulment of the law.|
Petrified|extremely afraid|Ashley is petrified of flying which is why she plans on travelling by bus to Houston for her nephew’s wedding.|
Petrify|to scare someone into inaction|Because heights petrify me, I will never get on a plane.|
Petty|small and insignificant|The officer did not arrest the teen for the petty crime.|
Petulance|characterized by being bad-tempered and unreasonable, especially because you cannot do or have what you want|After getting a shot, the infant showed increased signs of petulance and would not stop crying.|
Petulant|to describe a person or behavior that is irritable, especially in a childish way|He was a petulant child who was aggravated by the smallest things.|
Pew|a long bench inside a church which holds several people|In our small church, the front pew is reserved for the choir.|
Phalanx|a body of troops or police officers, standing or moving in close formation|A phalanx of soldiers marched in lockstep, while belting out slogans of war.|
Phantasm|something seen but isn't real and exists only in your imagination|The boy thought he saw a ghost, when it was simply a phantasm he perpetuated out of fear.|
Phantasmagoria|a bizarre combination or collection|If you are under the influence of alcohol or drugs, everything you experience may seem like a phantasmagoria, akin to a hazy dream.|
Phantom|a ghost|In her dream, Suzan was attempting to flee from a phantom that kept on getting closer, but for some reason she could not run away.|
Pharaoh|a ruler in ancient Egypt|The Pharaoh of the bible enslaved the Jews and was ultimately drowned at sea.|
Phase|a distinguishable part of a sequence or cycle occurring over time|The road widening project from two lanes to four is only at the initial phase and upon the completion is expected to help with traffic flow.|
Phenomenal|astonishing; extremely remarkable|After seeing the play, the critics praised the young actress on her phenomenal talent.|
Phenomenon|a person or thing that is often awe-inspiring because of its unique quality|The four-year-old boy was considered a phenomenon because he could play the piano like a master pianist.|
Phenotype|the physical appearance of an organism resulting from its genetic makeup and environmental influence|In the lab, we studied the effect of the weather on an albino mouse’s phenotype to see if the creature’s outward appearance changed.|
