Sheath|a protective covering, usually of a knife or sword|Carrying the sharp blade in its sheath helped protect the woodsman from accidental cuts.|
Shed|to take something off|As it shimmied along the rainforest floor, the peeling snake continued to shed his skin.|
Sheen|a quality of things with a smooth and shiny surface|I didn’t want the counter to have a shiny look, so I covered it with a paint with less sheen.|
Sheer|of transparently thin quality, usually of fabric|Peering through the sheer curtains, the ill and lonely boy watched his friends play outside in the snow.|
Shell|the hard-outer covering of something|The turtle’s tough shell helps him protect his soft inner body from predators that want to eat him.|
Shelter|to give temporary protection from something bad such as weather or danger|The homeless man set up a makeshift shanty to shelter himself from the bitter cold.|
Shenanigans|actions or behaviors that are dishonest, immoral, or stupid|Because my meal is taking forever to be prepared, I’m certain the kitchen staff is fooling around and engaging in shenanigans.|
Shepherd|a person who tends and guides over a flock of sheep|In charge of keeping sheep for their milk, meat, and wool, the shepherd had a powerful position in the clan.|
Sherbet|a creamy dessert similar to ice cream and sorbet that is usually made with milk, fruit juice, gelatin, and egg whites|The ice cream shop is now serving creamy orange sherbet alongside its other sweet treats.|
Shibboleth|a behavior or word that shows someone belongs to a particular class, ethnicity, culture, profession, nation, etc.|When the man spoke, it was obvious from his shibboleth that he was not a native English speaker.|
Shield|to protect a person or thing from something dangerous or unpleasant|My mother uses sunglasses to shield her sensitive eyes from the sun’s bright rays.|
Shift|to move from one place to another over a small distance|I had to shift my foot from where I had it in the sand because there was a pointy sea shell there that really hurt.|
Shiftless|having a shortage of ambition; lazy|The shiftless man spent most of his day sleeping on the couch.|
Shimmer|to twinkle and shimmer with a soft light|Silver spray paint helped the candidate’s signs shimmer and stand out in the school hallway.|
Shine|to give off bright light|A lone light did not shine bright enough for us to see what was going on underneath the dim carport.|
Ship|to transport goods from one place to another|It is easier to ship goods from plane than by boat since not every city is connected to a waterway.|
Shipment|a quantity of goods that are being shipped|Only one shipment of the exclusive toy arrived on time, leaving frenzied shoppers in a panic to get their hands on one.|
Shipper|a person or company that transports goods|An experienced shipper is needed to transport the fragile cargo from Chicago to Atlanta.|
Shipwreck|the destruction of a ship at sea|The lone survivor of the shipwreck, the injured man looked for anything on the shore to cover his wound with.|
Shirk|to dodge responsibilities|The man tried to shirk his duties by pretending to be ill.|
Shiver|to shake or tremble slightly as a result of being cold, sick, or afraid|The sight of the ghostly figure at the top of the stairs made me shiver with fright.|
Shoal|a group of fish swimming together in shallow water|A shimmering shoal of orange and white fish ducked in and out of the coral.|
Shock|to surprise someone|The news of her father’s murder didn’t shock Ann since he was always involved in drugs and violence.|
Shoddy|not done or made well|The shoddy porch collapsed one day after it was built.|
Shogun|a postmodern military ruler of Japan who was just under the emperor|In the 15th century, the shogun controlled both the military and finances of Japan.|
Shone|gave forth shining light|The sun shone brightly over the Pacific coast and made the water sparkle.|
Shoo-in|a person or thing that is certain to win or succeed|Although the public thought the governor was a shoo-in for reelection, he surprisingly lost the race by several thousand votes.|
Shook|making something emotionally disturbed|Seeing her husband out with another woman immediately shook the shocked wife.|
Shoot|to fire, launch, or otherwise propel a projectile|The sniper received the order to shoot the criminal with his rifle because he was threatening to kill his hostage.|
Shoot|to kill or wound something with a bullet or an arrow|The hunter aimed his bow at the unsuspecting deer and prepared to kill it with his arrow.|
Shooter|a person using a gun|Armed with a gun, the shooter charged into the theater and killed several people within a matter of minutes.|
Shore|the land along the edge of a sea or other body of water|Two survivors swam to shore after the small plane crashed in the bay.|
Shorn|to cut|He shorn the sheep with the sharp shears, turning it into a very short-haired sheep.|
Short|brief or temporary; Lasting for a small period of time|The students were asked to attend a very short meeting to quickly discuss changes to next year’s classes.|
Shortage|a lack of something|A shortage of teachers has put thousands of students in overcrowded classrooms.|
Shortcoming|a deficiency or failing|Her only shortcoming shown on the report card was in science because her lab reports were not written in the correct format.|
Shortfall|a failure to get an expected return|Because of fewer donations this year, the charity is facing a million-dollar shortfall.|
Shorthand|a method of writing using abbreviations and symbols|The secretary took notes in shorthand so that she could quickly write down all of the details.|
Shorthand|writing in a shortened way so that characters and marks are used in substitution of words|My lousy secretary couldn’t even take shorthand, so all of my correspondence was typed with missing sentences and phrases.|
Shortly|soon or in a short time|I will meet with each of you shortly, so you won’t be waiting on me for very long.|
Shortstop|a baseball position between second and third base|The shortstop ran between second third bases trying to secure an out for his team.|
Shout|to yell or speak loudly|Children often shout at one another because they do not have the communication skills to solve disagreements appropriately.|
Shove|to roughly push|When he’s packing for a trip, the disorganized man tries to shove all of his clothes into one suitcase.|
Showboat|to showing off an accomplishment|Riley is a skilled gymnast who likes to showboat her talents by performing complicated handsprings in from of the cheerleaders.|
Showcase|to display something|Hosting a free wine tasting event at the gallery was a way for the up-and-coming artist to showcase her work.|
Showdown|a confrontation or faceoff|Donald Trump and Kim Jong-un prepared for a political faceoff but called a truce right before their showdown.|
Showplace|an estate or building that is used as an example of beauty or history|The colossal plantation home was used as a showplace to show New Orleans visitors how impressively built these types of homes were.|
Showrunner|a creator of a television show that both directs and writes episodes for the production|As showrunner for both Scandal and Grey’s Anatomy, Shonda Rhimes not only created the television series but also served as head writer.|
Shrapnel|the pieces of a bomb or bullet that has exploded|Shrapnel rained down on the city as the bomb exploded throughout the building.|
Shred|to tear or cut something into small pieces|If we are going to have chicken tacos for supper, someone needs to shred the chicken breasts into smaller pieces.|
Shrew|a woman with an unpleasant personality|My manager is a shrew who goes out of her way to make my workday unpleasant.|
Shrewd|having or showing sharp powers of judgment; sharp-witted|It takes a shrewd analyst to really make a killing in the stock market.|
Shriek|to issue a piercing yelp or call|When the pop idol walked on the stage, the girls started to shriek in excitement.|
Shrift|remission of sins granted after confession|Granting the shrift, the priest told the parishioner to go in peace and sin no more.|
Shrill|sharp and high-pitched|The witch’s long nails made a shrill sound on the window.|
Shrine|a place where you worship or pay tribute to a specific deity, ancestor, hero, martyr, saint, or similar figure of awe and respect|The young man had a shrine dedicated to his favorite football player.|
Shrink|to lessen in size or stature|In order to shrink my debt with the bank, I had to double my mortgage payments each month.|
Shrive|to gain absolution for ones sins|After months of feeling guilty about the lies she told, the woman decided to shrive at the local cathedral.|
Shrivel|become wrinkled or get smaller|Soaking in the bathtub for too long, the girl’s tiny fingers began to shrivel up like wrinkled sticks.|
Shriveled|wrinkled and withered|After sitting in the sun, the once juicy and round grapes are now dry and shriveled.|
Shroud|an object that conceals something or someone|The celebrity covers her head and face with a shroud to conceal her identity when she goes out in public.|
Shrouded|covered to the point of being hidden|The military tank was shrouded by a camouflage tarp.|
Shrug|to show indifference or disregard, sometimes by raising and contracting the shoulders|The man’s tendency to shrug off his flu symptoms until it was too late landed him in the hospital over the weekend.|
Shrunk|to cause something to shrink or reduce|Placing the water temperature on hot shrunk my extra-large sweater down to toddler size.|
Shtick|a comedy routine or act|Part of the comedy show, the mime performed his shtick for a packed house.|
Shudder|to tremble suddenly|A cool breeze moved through the garden, causing the princess’s body to shudder from the chill.|
Shuffle|to mix-up, rearrange, or jumble objects|Since the dealer failed to shuffle the cards correctly, I got the same hand back to back.|
Shun|to avoid, especially persistently|Mom’s doctor told her that if she wants to live to see her grandchildren she must shun fatty foods.|
Shunt|to push or shove something|It’s unfortunate that our society tends to shunt older workers to retirement before they are ready.|
Shutter|a device that opens and closes to expose the film in a camera|Because the shutter closed too soon, overexposure occurred and the picture was ruined.|
Shuttle|a form of transportation that travels between two places on a regular basis|Waiting for the next shuttle to take them home, the coworkers made casual conversation.|
Shy|timid or bashful|Several shy maidens giggled as they coyly peered at the prince from behind their decorative fans.|
Shyly|doing something in a timid or bashful way|Unable to get over her bashfulness, the wallflower shyly watched the others dance.|
Shyster|a person, generally a lawyer, that uses fraudulent or questionable methods to do business|This lawyer is what we call a shyster, relying on underhanded and sometimes even illegal techniques to get results.|
Sibilant|associated with a hissing noise|The snake’s sibilant hiss caused the frightened puppy to flee.|
Sibling|one’s brother or sister|Even when you are close in age, sharing a room with a sibling can be difficult.|
Sibylline|having a secret meaning|It took several historians to understand the sibylline meaning of the ancient scroll.|
Sick|affected by a physical or mental illness|My daughter usually tries to fake a cold to get out of school on Mondays, but this time she actually was sick, and I let her stay home.|
Sickle|describes something with a curved or crescent-like shape|The patient’s sickle shaped cells were curved, not round like a normal person’s cells.|
Sickly|having weak or unhealthy feelings|With dead leaves and droopy flowers, the sickly plant required sunlight, water and rich soil to become healthy again.|
Sickness|illness or ailment|In medieval times, the people thought that sickness came from unholy behavior instead of unhealthy bacteria.|
Side-eye|a sidelong glance that shows disapproval or disdain|Anna gave her husband a disapproving side-eye when he mentioned spending their savings on a new boat.|
Sidekick|a person who is an assistant or close associate to another person and helps them in some way|My younger brother thinks he is my sidekick and follows me around the house.|
Sidelines|situation where one is witnessing an activity and not joining in|My sister and I sat on the sidelines of our parents’ arguments because we wanted to know what they were saying without giving our opinions.|
Sidereal|relating to distant stars, planets, or constellations|The scientist’s calculations were based on sidereal time, which was related to the earth’s rotation around fixed planets.|
Sidestep|to avoid or dodge something|Jumping out of the road quickly, the pedestrian was able to sidestep being hit by the speeding vehicle.|
Sidetrack|to cause someone to be distracted from an important issue|My phone tends to sidetrack me when I am trying to work, so I put it away to keep myself from being distracted.|
Sidewalk|a paved path for people to walk on beside a roadway|Bikers were afraid to ride in the middle of the busy street, so they cycled down the adjoining sidewalk instead.|
Sidle|to move in a discreet manner, often by walking sideways|Members of the rescue team will sidle around the building to avoid being seen by the kidnappers.|
Siege|a circumstance in which a group, usually a military or law enforcement agency, surrounds an area or building in an attempt to take it over|During the siege of the village, the villagers were forced to give up their property.|
Siesta|an afternoon nap that is usually associated with Mexico or Latin countries|Preparing for a quick siesta, the sleepy man rubbed his eyes and reclined his chair.|
Sieve|a utensil with holes that is used to separate items|Use a sieve to remove the pulp from the juice.|
Sift|to examine something carefully in order to locate an object of value|With the hope of finding survivors, the rescuers slowly sift through debris.|
Sigh|an audible release of air used to express a feeling|When the man realized his wife hadn’t been harmed in the car accident, he released a loud sigh of relief.|
Sight|vision, or the literal ability to see|The guards blinded my sight with a strip of cloth to ensure that I did not see the path they took to reach their secret base.|
Sightseeing|related to traveling around a region seeing interesting sights|Sightseeing tours to the ancient coliseum are only offered to large groups by reservation.|
Sign|to write or inscribe something|To buy the home, the couple had to sign their names in pen on several pieces of paper.|
Signal|a gesture or sign used to communicate|The biker used his left hand as a signal that he would be making a turn.|
Signatory|the signer of an official document, either a person or a country|The French government became a signatory of the treaty, signing the document in the late 1800s.|
Signature|a person’s name written by his or her own hand|With the largest signature, John Hancock is best known for the way he signed his name on the Declaration of Independence.|
Signature|a person's name written distinctively as a form of identification|By providing his signature on the form, the university student agreed to pay for all of his classes in full.|
Significance|worthy or valuable in a certain way|Timothy didn’t know the significance of the pocket watch his father gave him when he was a teenager until he found out later that it had been passed down for many generations.|
Significant|meaningful, noteworthy or important|Without any significant proof of his involvement, the man was let off with a stern warning.|
Signify|to mean or show something|In the painting the abandoned rose is supposed to signify a lost love.|
Silence|complete absence of noise or sound|Silence swept over the crowd once talkative crowd, as the speaker prepared to announce the winner.|
Silent|not making or accompanied by any sound|With no children at school to laugh or make noise, the classroom was eerily silent.|
Silhouette|a black outline of the shape of a person or thing|The silhouette in my locket is an outline of my mother.|
Silky|smooth and soft with a glossy texture|The woman liked to keep her hair soft and silky by washing and conditioning it every day.|
Sill|a piece of wood or metal that forms a ledge at the foot of a window opening or doorway|A leak around the front door sill allowed water to pour in to the building during the flood.|
Silly|acting ridiculous or childish|While watching the silly cartoon on television with the roadrunner chasing Bugs Bunny, the kindergartners laughed.|
Silly|goofy and playful|The children played silly games on the playground and laughed at each other’s funny antics.|
Silo|a farm tower used to store grain|Wheat is placed in a drying silo before it is sold in the farmer’s market.|
Silt|fine deposits of silt or clay that are carried by moving water or wind and settle at the bottom of a river|Larger than clay but smaller than sand, pieces of silt are moved by the fast-moving Mississippi and settle at the bottom of its river banks.|
Simian|of or pertaining to monkeys or apes|The actor mimicked simian movements for his role in Planet of the Apes.|
Similar|alike or close to the same|While the two brothers are not identical twins, they are so similar in looks and personality that I still cannot tell them apart.|
Similarity|a likeness or resemblance|The similarity in grandfather and grandson’s looks are uncanny, as most would not be able to tell their pictures apart.|
Similarly|in a like manner|In the military, all of the new recruits are similarly dressed.|
Simile|a comparison that generally uses like or as to make lofty or exaggerated descriptions of a person or object|The students were instructed to write a simile using ‘like’ or ‘as’ to compare their best friend to an animal.|
Similitude|the condition of being alike|Because the murders in the two states have similitude and share similar features, the cases will be given to the national police.|
Simmer|to cook slowly below boiling temperatures|The thick pasta sauce splattered all over the stove because it was meant to simmer, not boil!|
Simony|the act of selling church offices, roles, or religious pardons|Simony was outlawed by a few kings as the selling of church roles was frowned upon by many.|
Simpatico|to be well-matched and like-minded|Finding a simpatico partner in life has become easier for many single people since there are so many dating sites to find people with similarities.|
Simper|a silly or shy grin|The simper on Kate’s face causes me to think she gets nervous whenever she talks to a boy.|
Simple|easy; effortless|Mia needs a simple recipe to follow to create a quick dinner.|
Simpleton|an unintelligent or foolish person|The simpleton was so clueless, he didn’t realize that paper was made out of wood.|
Simplicity|the state of being easy or simple|After living in a huge city for twenty years, we were eager to enjoy the simplicity of small town life.|
Simplify|to make something easier to understand or do|The intellectually advanced professor tried to simplify the material for his less intelligent students.|
Simply|in a plain and straightforward manner|The designer likes to make her dresses simply and includes very few bright colors or details to the material.|
Simulacrum|an image or representation of a person or an image|Constructing a model-size simulacrum, the contractor hoped to give potential buyers a better understanding of what the condominiums will look like.|
Simulate|to duplicate or replicate an image or a behavior|Many homeowners use apps that simulate the sound of a barking dog to keep intruders out of their homes.|
Simultaneously|at the exact moment|The song sounded out of sync because the flutists were not playing simultaneously.|
Sin|an act that is against a religious or moral law|Isn’t it ironic that many people who believe murder is a sin still support the death penalty?|
Since|from then until now|Jen has suffered from the heart condition since birth, but just now discovered how serious it can be.|
Sincere|genuine; meaning what one says or does; honest|The judge agreed to lighten Howie’s sentence, if he made a sincere effort to improve his behavior.|
Sincerely|in a manner that sounds truthful or genuine|Because the doctor spoke sincerely, I really believed he cared about my health.|
Sincerity|honesty; in a way that is free of deceit|The traveler’s sincerity was questioned when he failed to declare funds to U.S. Customs agents.|
Sinecure|a position that requires no work but still gives a payment; a cushy job|Even thought we all thought of the job as a sinecure, Jane took her position very seriously and always worked late into the evening.|
Sinew|sturdy tissue that links bones to muscles; also referred to as a tendon|By injuring your Achilles tendon, you’ve injured a sinew in your leg that links the muscles of your calf to your heel.|
Sinewy|powerful and sturdy|Three sinewy men were able to lift the tree off the car.|
Sinful|wrong morally or ethically|Eve’s lapse in morality caused Adam and the rest of the world to be punished for her sinful actions.|
Sing|to use one’s voice to make musical sounds|The carolers will lift their voices and sing cheerful hymns this Christmas.|
Singe|to burn something in a superficial way|The spicy food began to singe my mouth as soon as I took a bite.|
Single-file|one behind the other|The students were asked to stay in a single-file line, walking one behind the other all the way to the cafeteria.|
Single|one solitary or lone object|A single shot was fired from the gun, but that one bullet was enough to kill the victim.|
Singular|remarkable, extraordinary|Although it isn’t widely known, the book is regarded as a singular and powerful piece of 19th century writing.|
Singularity|the act of being the only one of something; on its own|Since the hiker was stranded having the singularity of one match in his pocket, the hiker realized he would only have one chance to build a fire.|
Sinister|wicked or evil|The policeman quickly took note of the sinister man’s appearance.|
Sink|to float down|A hole in the bottom of the boat caused it to fill with water and sink down to the bottom of the lake.|
Sinner|a person who does things that are wrong or immoral according to religious law|The holy book calls for any sinner who commits adultery to be stoned to death.|
Sinuous|winding and twisting|According to the treasure map, the cave is located at the end of the sinuous path that winds up the mountain.|
Sip|to drink something slowly|I had to remember to sip the wine slowly so that I would not get a headache.|
Siphon|to draw off liquid by means of a tube|The sneaky thief used a long tube to siphon the gasoline from the woman’s vehicle and put it into his own.|
Sire|the father of an animal, especially a horse or bull|Although he had never won any awards, the son of the sire was a prize-winning pony.|
Siren|an object that makes a loud noise as a warning|A wailing siren and news broadcast alerted viewers that a twister had been spotted on a nearby farm.|
Sisyphean|describing something that appears or actually is endless|We hired a dozen extra workers to help us with the Sisyphean task of moving out of our sixteen-bedroom mansion.|
Site|a place where a specific event has occurred|Stalingrad is the site of one of the most heated battles of World War Two’s eastern front, with massive casualties for both the Germans and the Russians.|
Situate|to place something|The seasoned gardener suggested I situate the plant that is sheltered with at least partial shade.|
Situation|the location or circumstances of something compared to the things around it|With the impending hurricanes, I knew my sister’s situation was desperate since her house was flooded.|
Situation|a set of circumstances or surroundings that one is in|The soldiers were surrounded, and they had no choice but to surrender considering the gravity of their situation.|
Situational|dependent upon a certain set of circumstances or situations|The punishment for the crime seems to be situational since some of the cons go to jail and some get probation instead.|
Sizzle|to make a hissing sound while frying or burning|Begin by heating the frying pan until drops of water tossed into sizzle.|
Skedaddle|to flee or go away hastily|When the tornado turned toward the storm chasers, they realized they had better skedaddle to a safer location.|
Skein|the V-formation that ducks and geese fly in when they are migrating|Because they like to stick together when they are migrating for the winter, ducks and geese fly in a skein, which is a formation in the shape of a V.|
Skeleton|an internal framework or body used to protect and support|After the fire, the building’s metal skeleton was the only thing left standing.|
Skeptic|a person who doubts that an idea or belief exists or is valid|Being a skeptic, the woman highly doubted that the psychic would really be able to tell her future.|
Skeptical|having reservations or doubts about something|Although the car salesman assured us that the used SUV wasn’t a lemon, my skeptical mother was hesitant to believe him.|
Sketch|a rough drawing of something|A sketch of the main suspect’s face lead authorities to capturing the robbery trio.|
Skew|slanted, crooked|Because we didn’t use a level when hanging it, the picture was skew on the wall.|
Skewed|leaning towards a side|Her views of Her grandparents had been skewed after years of her parents telling her how rude and evil they were.|
Skewer|a piece of metal or wood used to suspend food while cooking|Roasting s’mores over the fire on a skewer is one of our camping traditions.|
Skiff|a boat small enough for sailing or rowing by one person|The fisherman hoped that the small skiff would be able to hold all of the fish he caught.|
Skill|a particular ability or expertise|The woman’s writing skill helped her stand out amongst all the other writers in the field.|
Skilled|having the ability or skill to do something well|Drawing back his bow, the skilled archer prepared to hit his target as he usually did.|
Skillful|being good at doing a certain task|A skillful painter, the artist was able to capture any image on canvas.|
Skim|to go over something quickly|Not having enough time to read all of the assigned chapters, I decided to skim through the pages and home for the best.|
Skinflint|a person who spends as little money as possible|The skinflint refused to spend money, even on things that are necessary.|
Skinny|extremely thin|Sauntering down the runway, the skinny model appeared rail thin.|
Skip|to move past one thing in order to do the next|Since I was tired, I decided to skip morning church service and attend the afternoon mass instead.|
Skipper|the captain of a ship or boat|The skipper of the boat guided the vessel through the storm and made it safely into the port.|
Skirmish|a skirmish is a brief argument|Several players got into a skirmish following the first play of the game.|
Skirt|skirt is to go around something instead of directly through it|Do not skirt around the truth about this issue, tell me exactly what happened and when.|
Skirting|skirting is going around something instead of straight through it|The daughter tried skirting around the truth about how she wrecked her car.|
Skittered|glided or skipped lightly over the surface of something|As the rain beat down on the highway, a car skittered across the slick road and careened down the hill.|
Skittering|to glide or skip lightly over the surface of something|After skittering across the surface of the lake, the pebble Gretchen tossed finally sank down to the bottom.|
Skulduggery|behavior characterized by tricking someone into something or cheating them through lies or misinformation|The insurance company was investigated by the FBI after claims of skulduggery and cheating customers was reported.|
Skyrocket|to rise very quickly|After one hit movie, the actress’s career seemed to skyrocket to success.|
Skyrocket|to increase very steeply and quickly|Gas prices usually skyrocket in the summer when lots of people are traveling and fuel is in great demand.|
Skyscraper|a skyscraper is a tall building with many stories|The contractor is building a new eighty-story residential skyscraper in downtown Houston.|
Slab|a slab is a large, thick piece of wood, concrete, or stone|The newlyweds went to the home improvement store to narrow down their favorite stone slab for their new home.|
Slack|slack means loose, not tight|I took my new dress to the seamstress because it needed slack added to the waist.|
Slacken|slacken means to loosen or lessen|You really need to slacken the seatbelt before you choke yourself.|
Slain|slain means to kill in a violent manner|Their son, slain in the shooting, began his career as a prison deputy at a local jail.|
Slake|slake means to quench or satisfy one’s thirst|This electrolyte water should help slake the runners’ thirst during the marathon.|
Slam-dunk|an expression that means to achieve or accomplish something easily|Although he thought the exam might be hard, the pleasantly surprised student considered it a slam-dunk.|
Slam|to shut something loudly and with great force|When he is angry, grant likes to slam his bedroom door so hard that the walls shake.|
Slammer|a slang word for prison or jail|Having spent ten years in the slammer, the ex-con wasn’t afraid of doing hard time for his crimes.|
Slander|to make a statement that cannot be proven in order to injure someone’s reputation|To win the election for homecoming queen, Jill resorted to slander to ruin her competitors’ reputations.|
Slang|a form of informal language|The children used slang as a secret language, not realizing their parents had cracked their codes long ago.|
Slant|a slant is a lean, bend, or slope|The slant of the mountain side made a much easier track for the mountain climbers than the strictly vertical path.|
Slapdash|done quickly without consideration for accuracy|Because I gave my mother very little notice, she had to plan a slapdash wedding ceremony for me.|
Slash|a slash is a cut|There was a slash through the doorway that allowed the thief to break into the enormous mansion.|
Slate|a thin piece of rock that is often used a writing surface|Writing the letter A on the smooth slate, the teacher demonstrated correct form for her students.|
Slaughter|the killing of a large number of animals or people|Mass slaughter of the Jewish people is one of history’s most senseless tragedies.|
Slave|a person who is legally owned by another|Slave labor was used in the southern colonies where large amounts of workers were needed to produce crops.|
Slavery|the practice of owning people as property and requiring them to serve and work for free|Escaping slavery herself, Harriett Tubman helped other slaves make it to freedom in the north.|
Slay|to kill something in a violent way|Determined to slay the dragon, the knight raised his sword to deliver a strike.|
Sleazy|shabby, dishonest, immoral|The sleazy salesman would make up anything to sell his product.|
Sleet|rain and snow mixed|The combination of snow and rain in the form of sleet rained down on the driver’s windshield.|
Sleigh|a sled drawn by horses, especially reindeer|Reindeer guide Santa Claus’s sleigh as he travels down the snowy mountains to deliver gifts to all the children.|
Sleight|the manipulation of cunning or skill, particularly as a means of deception|The card cheat used a sleight of hand trick to ensure he won the biggest pot of the night.|
Slender|slim; lean|Tall and slender, the model’s thin legs were one of her best assets.|
Sleuth|a detective or investigator who solves mysteries|Making a name for himself as a hard-hitting detective, the sleuth prides himself on being able to solve cold cases.|
Slew|to have killed something/someone|Zeus slew many of his enemies by literally striking them down with bolts of lightning.|
Slice|to cut something|Using a butcher knife, the deli worker continued to slice the meat into think pieces.|
Slick|smooth and glossy (usually of a surface)|Rain caused the road to become wet and many cars to skid across the slick surface.|
Slide|to scoot or move across something without lifting from the item|The gambler watched the dealer slide the cards across the table and prayed for a good hand.|
Slight|small or minimal in degree|Although she had a slight fever, the woman still felt well enough to go to work.|
Slightly|a tiny bit|Jamie loved that her best friend was only slightly bigger in size so that they could share each other’s clothes.|
Slim|slight or unlikely; slender or thin|After the terrible car accident, the driver only had a slim chance with about a 10% survival rate since he incurred extensive brain damage.|
Slimy|covered in or having a moist, soft, and slippery surface that is usually considered gross or repulsive|The slimy frog felt cool and moist to the touch when being held by the curious children.|
Slip|to slide or fall after losing one’s balance or footing|Water pooled on the grocery store floor caused a customer to slip and fall into the puddle.|
Slit|a long, narrow cut or opening|The long slit in the woman’s evening gown went from her ankle all the way up to her thigh.|
Slog|to work extremely hard over a period of time|The road workers were forced to slog it out and continue the construction even through the holidays.|
Slogan|a short noticeable motto for marketing a product or service|Once people started to remember the catchy slogan of the company’s popular frozen foods, this product’s sales increased.|
Slope|a surface that has one end that is higher than the other|The children slid their sled from the top of the hill to the bottom, laughing as they zoomed down the slope.|
Sloppily|messy, dirty, disheveled|He showed up to the interview so sloppily dressed that they turned him away at the door.|
Slosh|the sound of splashing|The distant slosh of the waves on the sandy beach was a relaxing sound as I attempted to take a nap.|
Slothful|lazy and idle; wanting to do nothing|Because he was so slothful, the lazy husband laid in bed every day while his wife worked.|
Slouch|to stand or sit in a stooped, slumped, or drooping way|Too tired of sitting up straight, the exhausted student began to slouch down in his chair.|
Slough|to cause to shed or purge|The product is designed to slough off dead skin cells.|
Slovenly|having a dirty appearance|The man’s slovenly dress was a result of him being homeless for a month.|
Slug|a slimy mollusk that lacks a shell and secretes mucous as it drags its body along the ground|The slug took over the man’s garden, dragging its slimy body over the plants as it munched.|
Sluggard|a generally lazy and unproductive person|Jonas was your typical sluggard who loved nothing more than laying in his bed and playing video games all day.|
Sluggish|slow-moving and lacking in energy|After staying up all night, the tired teenager was sluggish when morning arrived.|
Slum|a poor area of a city where the living conditions are really bad, and the houses are falling apart|Deep in the slum, the people were living in terrible poverty in shacks that were barely standing.|
Slumber|sleep; rest|The bear awoke from his slumber, stretching and yawning after a month long nap.|
Slumgullion|a cheap stew that is made of meat and vegetables but is thin like water|The poof family could only afford to make slumgullion and slurped the thin stew at every meal.|
Slump|to fall suddenly of prices, values, and sales|After a successful mowing season, winter caused service calls to slump.|
Slunk|crept or snuck|After noticing the light on in the living room, the teenage girl slunk back into the house after her curfew by crawling up the tree and into her bedroom window.|
Slur|to speak and mumble in a way that the words run into each other and can’t be understood|The drunk patron started to slur and mumbled his words as he stumbled around the bar.|
Slush|ice or snow that is partially melted|As the snow began to melt, it left behind a thin layer of watery slush.|
Sly|having or showing cleverness in a cunning or deceitful manner|Instead of a ‘yes’ or ‘no’ answer, he gave a sly smile as a response.|
Smack|to hit something or someone quickly with an object or the palm|The angry woman tried to smack her husband in the face, but he dodged the blow.|
Smackdown|the result of a humbling confrontation or defeat|After laying the smackdown on his opponent, the wrestler celebrated his victory by bragging to everyone in the arena.|
Small|of lesser size than normal|The skinny girl ordered a very small dress to wear to the dance.|
Smarting|the sensation of feeling a sharp pain or hurt|The football team is still smarting over their loss to their rival but must prepare for the next game.|
Smash|to break something into several pieces through brute force|If my large dog sees a squirrel outside the window, he may accidentally smash the glass trying to get to it.|
Smear|to spread a substance messily|The baby used her fingers to smear paint all across the paper.|
Smell|to detect the odor or scent of something using your nose|Amy stopped to smell the flowers in the garden because she loved the sweet scent.|
Smelt|to extract metal from ore through a heating process|In order to get useable metal out of iron ore, you must smelt it with extreme heat to get rid of the useless impurities.|
Smile|to turn the corners of one’s mouth up as a way of showing happiness or kindness|Tim was able to make his baby smile and giggle by tickling him under his chin.|
Smirk|a confident and often gloating smile|The smirk on his face told her that he was being sneaky.|
Smirk|a kind of smile that one gives when acting in a smug or conceited way|Because she knew the answer to the difficult math problem, the smug student shot a smirk toward her confused classmates.|
Smite|to strike something with a firm blow|Bringing his sword down swiftly, the knight tried to smite the enemy before he could get away.|
Smithereens|very tiny pieces|As the bomb exploded, it blew all of the paper close to it into tiny smithereens.|
Smitten|in love|The boy was completely smitten with his new babysitter, smiling whenever she was near.|
Smog|fog or haze that is polluted with smoke|Thick smog filled the air outside of the huge factory, polluting the sky all around the plant.|
Smolder|to burn with no flame and little smoke; to have strong restrained feelings|After we extinguished the bonfire, it continued to smolder for a long time.|
Smooth|having a surface texture that is flat and level with no bumps or uneven spots|The smooth highway pavement was very different from the bumpy dirt roads we are used to traveling.|
Smoothly|in an easy, flowing way|Everything was going smoothly during his driver’s test until he forgot to use his signal to turn and drove through a stop sign.|
Smorgasbord|a collection containing a variety of things|Fitness experts recommend trying a smorgasbord of cardiovascular activities to discover new hobbies.|
Smote|to knock down or kill with great force|With one touch, the war god can smote you into ashes.|
Smother|to restrict or stifle the airflow of someone or something requiring air or oxygen|When the camp leader decided he needed to smother the fire before going to bed, he took his booted foot and stomped it out.|
Smudge|a smeared mark on the surface of something|Wiping her eyes while crying, the bride tried hard not to leave a smudge from her makeup.|
Smuggle|to bring something into or out of a place by concealing it|Police were there to arrest the woman trying to smuggle drugs into the airport.|
Snag|to tear or rip something after catching it on a sharp projection of some kind|I tried not to snag my dress on the rosebush but got it caught anyhow.|
Snaggletooth|a smile with a tooth or teeth that are crooked and project out past others|Many of the first graders have snaggletooth smiles, so they rarely ever tease each other about their crooked teeth.|
Snap|to break|Feeling the tree branch snap beneath my weight, I prepared to hit the ground below.|
Snapshot|an informal photograph taken quickly|While looking through an old photo album, Chelsea found a snapshot of her grandmother when she was very young.|
Snare|a trap|Finding himself in the middle of a bureaucratic snare, the politician wished that he had never trusted his fellow cabinet members.|
Snarky|sarcastic or caustic in nature|My friend asked a pretty dumb question, so naturally I decided on a snarky response dripping with enough sarcasm to let him know how silly it was.|
Snarl|growl|Cowering in fear, Pete and Jerry heard the snarl of an unknown animal while walking in the haunted forest.|
Snatch|to grab something quickly|I tried to snatch up my most precious belongings before I ran to safety, but the smoke from the fire proved too much for my lungs.|
Sneak|to move about in a sly and secretive manner|My friends wanted to sneak into the theater without a ticket, but I was too afraid of getting caught.|
Sneaky|behaving in a sly or secretive manner|The sneaky teenager quietly snuck out her bedroom window while her parents slept.|
Sneer|to speak or smile in an unkind way|Mark gave Ted a condescending sneer when he walked into the meeting.|
Sneeze|suddenly and involuntarily blowing air from the nose|As the boy slept, his sneaky sibling tickled his nose with feathers that caused a terrible sneeze!|
Snicker|to let out a half-suppressed laugh in a disrespectful way|The judges tried not to snicker at the beauty queen’s misguided rant about how world hunger affects Americans the most.|
Snide|indirectly unkind or insulting|Tina always made snide and cutting remarks when trying to hurt her younger sister’s feelings.|
Sniff|bringing in air through the nose in order to smell something|Having the carsick woman sniff and taste ginger helped her to feel a little better.|
Sniffle|to sniff over and over again, usually when sick or crying|Sniffle attacks plagued the ailing twins and caused their noses to run constantly.|
Snip|to cut something with a small, quick stroke|If you snip the suckers off of the bush too quickly, the blossoms will never appear.|
Snipe|to shoot at someone from a hiding place|The soldier used his long-range rifle to snipe his targets off of the building.|
Sniper|one that shoots at someone from a hiding place|The sniper hid with his rifle behind the bushes and laid in wait for his first victim.|
Snippet|a small piece of something|A snippet of the code was placed on the screen for viewers to copy down.|
Snippy|used to describe rude behavior or communication that is brief or curt|My lab partner comes off as a bit snippy, but I think it is simply his nature to be brief when working on a project.|
Snitch|a person who reports the wrongdoing of others to someone in an authority position|Fearing that he would be labeled a snitch, the man made sure that no one at the company knew he was filing a complaint.|
Sniveling|whining while in tears|The little boy was sniveling as he begged his mother not to punish him.|
Snob|a person who is condescending and thinks they are better than those around them|The clothing snob constantly bragged about how she never wore the same outfit twice.|
Snobbery|the attitude or behavior of a person who is condescending and thinks they are better than those around them|With a cold and distant attitude, the rich woman’s snobbery kept her alone and without an close friends.|
Snobbish|describes a person who looks down on others based on superficial reasons (good looks, wealth)|The snobbish woman is in desperate need for a job but still refuses to work in a fast food restaurant.|
Snoop|to look around a place secretly, in an attempt to discover things or find out information|Deciding to snoop through her husband’s pockets, the woman looked around to make sure the coast was clear.|
Snooty|an attitude of disdain or contempt towards others|The most popular girl in school is especially snooty, looking down on almost every other student and acting like they are beneath her.|
Snooty|rude and arrogant, especially to those from a lower class|The snooty heiress refused to associate with anyone in a lower class than her.|
Snore|breathing with a grunting or snorting sound while sleeping|Hearing a loud snore coming from the living room, the children ran down the stairs to find grandpa sleeping in the chair.|
Snout|the mouth and nose of an animal that projects out|Placing its snout up to the ground, the dog sniffed around in search of the suspect.|
Snow|frozen water vapor that falls down in small flakes|Glistening white snow fell lightly from the clear sky.|
Snub|the ignoring or brushing off of someone|The waitress insisted that her lack of attentiveness to the table wasn’t a snub, but an accidental oversight.|
Snuff|to put out a flame|Blowing out the flicker quickly, the boy was able to snuff out the candle and hop into bed before his mother walked into the room.|
Snug|fitting tightly|The baby’s car seat belt must be snug so that she will be protected in case of an accident.|
Snuggery|a comfortable place or position|The quaint cabin was a snuggery of privacy and reflection for the writer.|
Soar|to rise high|Gas prices always seem to soar in the summer when families are getting ready to travel.|
Sob|to cry in a noisy fashion or a loud gasp made when a person cries|Spoiled toddlers often sob when their parents leave home.|
Sober|sober means solemn, serious, and sensitive|The interviewee gave a blank sober stare into the camera lens prior to her meeting.|
Sober|not affected by alcohol or illegal drugs|While in his sober state, the man was much more irritable than when he was drinking.|
Sobriety|the state of being not using alcohol or illegal drugs|Sobriety tests showed that the driver was inebriated and not able to operate a vehicle.|
Sociable|friendly and willing to spend time and talk with other people|Out of all the party guests, my sociable neighbor was the only one to make conversation with me.|
Socialism|a system of rule in which the government controls the main industries|Under a system of socialism, the government manages the country’s major businesses.|
Socialist|an individual who supports the policies of socialism|A socialist is a person who favors the principles of socialism in government.|
Socialite|a trendsetting young woman who is frequently seen at society’s important events|As a socialite, I normally attend two or three social events each week.|
Socialization|the process of talking to or doing activities with others|Socialization with humans was difficult for the rescue pup since he had been abused in the past.|
Socially|relating to society or a social situation with others|Being socially awkward around the opposite sex kept the science teacher from getting a date.|
Society|an organized group of people|Homeowners contested that the property tax was unfair since it singles out one segment in society.|
Socioeconomic|socioeconomic is a term used to describe social and economic factors|A student’s socioeconomic status is used to determine who receives free school lunch.|
Sociologist|a sociologist is a person who studies patterns of social behavior|The sociologist concentrates on patterns of behavior shared by members of a society.|
Sociology|sociology is the scientific study of social behavior, patterns, and structure|During this course, students will gain a precise understanding of sociology as the scientific study of social structure.|
Sociopath|a sociopath is a person possessing a personality disorder that involves having very little regard or concern for others|A sociopath does not practice understanding or compassion for others, as he is only concerned with self.|
Sockdolager|a decisive and often unexpected blow|President Trump’s win came as a surprising sockdolager to both Democrats and Republicans alike.|
Socrates|a Greek philosopher who known for his thoughts on justice and virtue and is credited for laying the foundation of Western Philosophy|Greek philosopher Socrates rejected the idea that how virtuous a person is depends on age or gender.|
Sod|the grass covered surface of land|Adding grass seed to a lawn can be a long process, but it is much less expensive than laying sod with grass attached.|
Sodden|soaked in fluid|My shoes were sodden after I walked a mile in the rain.|
Sodium|an element that is found naturally in many things and when combined with chloride, results in table salt|Sodium is an element found in the ocean, causing the water’s saltiness.|
Soften|to make or become less harsh or hard|Curtains soften the sun’s rays, stopping the bright light from shining through in the morning.|
Softly|in a gentle and quiet way|Rocking the baby softly, the new mother tried to keep from waking her slumbering newborn.|
Softness|not hard or firm|The pillow’s softness made the man feel as if he was sleeping on a cloud.|
Sog|a piece of marshland that is soft and wet|The farmer’s boots sank into the squishy mud as he stepped out onto the sog.|
Soggy|something that is wet and soft|The toddler spilled juice on her bread and refused to eat it because it was soggy.|
Soigne|polished, well-groomed or dressed|Looking soigne, the debonair gentleman stepped out of the limousine.|
Soiree|an elegant party or event|Attendees of the soiree are expected to dress in star-studded attire.|
Sojourn|a brief stay|As a teacher, I am looking forward to my sojourn at the beach during spring break.|
Sojourner|a person who temporarily resides or stays in a place|A servant and a sojourner stayed at the inn, but only for a short period.|
Solace|comfort in grief|After Maureen’s husband died, she sought solace in the church.|
Solar|related to the sun|Solar panels on buildings can reduce the amount of electricity used since they rely on energy from the sun.|
Solder|a fusible metal (usually tin or lead) that is used to join other metals together|Half of the world’s tin is used for solder, specifically to fuse other metals together.|
Soldier|a person serving in the military|A soldier serves in the military and bravely puts his life on the line to defend our many freedoms.|
Sole|only|As the sole heir to her parents’ fortune, the selfish woman felt lucky to be an only child.|
Solecism|something that isn’t seen as normal or appropriate; a deviation from the norm|According to the fashion critic, the actress committed a major solecism when she wore white after Labor Day.|
Solely|not involving anyone or anything else, or performed by only one person|Walking the dog is solely Gordon’s responsibility, and if the dog pees on the carpet we all know that he didn’t do his job.|
Solemn|extremely somber or serious|My mother’s solemn expression told me she was not in a playful mood.|
Solemnity|the condition of being serious or formal|In due solemnity, the minister pronounced us husband and wife.|
Solemnize|to perform a marriage ceremony|The reverend agreed to solemnize the marriage as long as the bride and groom agreed to counseling.|
Solicit|to request or ask for something|Many businesses put up signs to discourage others from going there to solicit.|
Solicitation|actively seeking out others in order to obtain a favor or money for a specific cause or business|The homeowner’s association called the police on the door to door salesmen because there was a strict policy of no solicitation in the community.|
Solicitor|a solicitor is a person who tries to obtain business from others usually related to sales|The insurance salesman acted like a solicitor, his demeanor resembling more of a peddler than a professional.|
solicitous|full of anxiety and concern|I am going to keep a solicitous eye out for criminals in this hard-hit neighborhood.|
Solicitude|care or concern|His solicitude was shown by the fact that he brought flowers to her every day.|
Solid|firm; stable|The murderer had a solid alibi that kept him from being charged with the crime.|
Solidarity|unity that occurs among people with a shared purpose|Since John is an African American, he joined the Black Student Union in college to show solidarity for his race.|
Solidify|to reinforce or make something stronger|The woman’s constant complaining only seemed to solidify her husband’s resolve to skip out on household chores.|
Soliloquize|to talk to one’s self|Alone on the island, the stir-crazy man had no choice but to soliloquize since there was no one else to talk to.|
Soliloquy|a monologue that is spoken out loud by an actor or actress|Speaking her internal thoughts as she moved about, the Broadway star gave a stellar soliloquy through her moving speech.|
Solipsism|the idea that the only thing we can be truly certain of is our own existence|The philosophy of solipsism dictates that we can only be sure of our own existence, and that everything else may just be a figment of our imagination.|
Solitaire|solitaire means a single gem set in a piece of jewelry|The bride’s engagement ring had a single, solitaire diamond that was striking at first glance.|
Solitude|aloneness; state of being alone|The man went out to the woods to escape from his busy life and get some solitude.|
Solo|a piece of music for one performer|The auditions for the senior solo were to take place tomorrow.|
Solstice|the time when the sun is furthest north or south of Earth's equator|The summer solstice occurs in June and is the longest day of the year.|
Solubility|the condition of being soluable and dissolved in liquid|Salt has great solubility, immediately disappearing into the solution.|
Solute|solute is a small component in a solution|In this mixture, a solute is dissolved in another substance.|
Solution|the answer to a problem or situation|The struggling agency is looking for a solution to their low funds problem.|
Solvent|able to pay all financial obligations|When the man realized he was not solvent and was unable to provide for his wife and kids, he killed himself.|
Somatic|somatic means relating to the human body|It is difficult to link generic somatic symptoms, like an irregular heartbeat, to specific illness.|
Somber|grim or miserable|When I saw the doctor’s somber expression, I knew my diagnosis was not a good one.|
Somehow|in a way that isn’t known|Lily will find the money for the bills somehow, but she isn’t sure where it will come from just yet.|
Somersault|a somersault is an acrobatic flip|Macie did a forward somersault to show off her acrobatic skills.|
Sometimes|happening from time to time (occasionally)|Alex and his sister go to the gym sometimes, but it’s not an everyday occurrence.|
Somewhat|to some degree or measure|I’m somewhat hungry, but I not so starving that I can’t hold off until lunch.|
Somnambulant|sleepwalking or resembling a sluggish sleepwalker|After taking his night medication, the somnambulant sleeper would end up eating ice cream while still asleep!|
Somnambulate|to walk while sleeping|The sleep therapist was studying patients who somnambulate.|
Somnambulism|somnambulism is engaging in activities such as walking while asleep|The child’s somnambulism caused the parents to add extra locks to the doors so that she couldn’t leave the house while sleep walking.|
Somnambulist|a somnambulist is one who sleep walks|The somnambulist has no idea she sleep walks to the neighbor’s house nearly every night.|
Somniferous|somniferous describes something that prompts sleep|Since her prescription sleep aid had a fast-acting somniferous effect, the woman has to be prepared to fall asleep soon after taking it.|
Somnolent|likely to induce sleep|The moonlight, along with the somnolent lapping of the waves on the shore, set the perfect scene for a romantic evening.|
Sonar|a device that is used to detect or locate objects under water|Using its sonar as a tool, the dolphin swiftly navigated itself through the murky water.|
Sonata|a long piece of classical music that is composed for one or two instruments and contains several parts|Through most of the sonata, the musicians played in an up-tempo.|
Sonic|related to sound or sound waves|Sonic whooshes from the guitar caught the music critic’s attention.|
Sonnet|verse form consisting of fourteen lines|Every time grouchy Bob began to hear a sonnet, he would cover his ears.|
Sonorous|able to produce a deep sound|Even without a microphone, the singer’s sonorous voice filled the entire room.|
Soonest|as soon as possible|The soonest that we can get a flight out of Dallas is nine p.m. since the other flights are overbooked.|
Soot|fine black powder|With a broom in his hand and a song in his heart, the chimney sweeper went about his task of sweeping up soot.|
Soothe|to calm or ease|The calming aloe vera plant is used be people all over the world to soothe burns and skin irritations.|
Soothing|calming; comforting|A soothing lullaby helped the baby drift into a deep and restful sleep.|
Soothsayer|an individual with the ability to predict the future|In the old days, the tribe’s soothsayer would predict the best day for battle.|
Sophism|a clever but untrue argument that is used to deceive someone|The debater’s argument was pure sophism and had no evidence to support it.|
Sophistical|misleading or erroneously deceptive|The scientist’s sophistical logic led many to believe the earth was flat instead of round.|
Sophistication|an understanding of the world and its ways, particularly knowledge and culture|The epitome of grace and sophistication, the debutante, came from a rich family that taught her both culture and class.|
Sophistry|a reason or argument that sounds correct but is actually false|Although the cult leader knew he was being dishonest with his group members, he hoped they would believe his sophistry.|
Sophomore|an individual in his/her second year of university or high school or a second release or effort|The rapper’s sophomore album was not as popular as his first musical release.|
Sophomoric|juvenile, immature, and lacking good judgment|After drinking too much alcohol, the celebrity made sophomoric comments that turned his fans against him.|
Soporific|causing or tending to cause sleep|The professor’s boring speech was soporific and had everyone in the audience yawning.|
Soprano|highest female singing voice|Sylvia’s voice was too deep to sing the soprano part.|
Sorbet|sweet, fruit-flavored ice that is served as a dessert|Although it is a simple dish, the icy lemon sorbet is one of the café’s most popular sweet treats.|
Sorcery|the utilization of magical abilities acquired from evil souls|The dark knight used sorcery to hypnotize the king.|
Sordid|very bad or dirty|If people learn of the politician’s sordid past, they will not vote for him.|
Sore|tender; painfully uncomfortable|Rubbing his sore ankle, the runner hoped that the pain would subside before his next meet.|
Sororal|of or pertaining to a sister; sisterly|Amy and Lynn grew up together and had developed a very sororal friendship.|
Sorority|a social organization of female students at a college or university|Every year Mary would meet with her sorority sisters to reminisce about their college years.|
Sorrow|misery or grief|The singer wrote a ballad to express her sorrow over a failed relationship.|
Sorrowful|displaying or causing misery|It was the policeman’s job to deliver the sorrowful news about the child’s death.|
Sorrowfully|sadly; mournfully|Sobbing sorrowfully, the widow finally gave in to the deep pain for losing her husband in battle.|
Sorry|remorseful; repentant|Although she was sorry for what she had done to her heartbroken husband, the adulteress seemed unable to show her remorse.|
Sort|to arrange things in groups based on shared qualities|The teacher asked me to sort out the graded assignments based on which student they belonged to, so they could be handed back to the class all at once.|
Sough|a moaning or sighing sound|The sough of the winds during the storm reminded grandma of the moaning of a child in pain.|
Sought|desired, wanted|After having a child with Down syndrome, they sought out a doctor for his research on mental disorders.|
Soul|the inner spirit or essence of a human being|Believing she was his soul mate, the knight professed his love for the maiden who had an inner essence as pure as his own.|
Soulful|expressing feeling or emotion|The singer crooned out a soulful melody that expressed all of the emotions bottled inside.|
Soulmate|a romantic partner which one has a strong connection (usually lifelong) connection|Ella knew that Ben was her soulmate and hoped that they would marry soon.|
Sound|noise produced by continuous and regular vibrations|An eerie sound coming from the top of the attic spooked the home owners.|
Sound|vibrations that travel through the air and can be heard upon reaching a person or animal’s eardrum|Anything that you can hear is a sound, a vibration that travels through the air and enters your perception through your ear.|
Soundness|being in good condition|The soundness of the wood was quite surprising since we bought the desk at such a low price.|
Sour|bitter or resentful|Sour glances were exchanged between the two social adversaries at the fundraising gala.|
Source|basis; foundation|Although the source of the infection could not be found, it was eventually cured with antibiotics.|
Southern|situated in the south|Sweet tea is a southern favorite that is enjoyed more here than any other part of the country.|
Souvenir|an item of sentimental value, to remember an event or location|On our first date at the beach, I grabbed a seashell as a souvenir to remind me of how our loving relationship began.|
Sovereignty|power; authority; control|The hijackers demanded that China relinquish its claim of sovereignty over Hong Kong.|
Sow|to spread or scatter|The old adage, you reap what you sow, means that whatever one spreads they also will gain.|
Sown|scattered; disseminated|After he seeds were sown throughout the fields, the farmer prayed for adequate rain to help his crop grow.|
Space|a place or area|The doctor is looking for a new office space to move his practice to next year.|
Spacious|with a generous amount of space|Since Frank and Janet have five kids, they need a spacious vehicle.|
Spade|a garden shovel|Digging into the dirt with the spade, the gardener made neat rows to hold his petunias.|
Spake|a past tense form of speak and synonym for spoke|Then the oracle came and spake to them, telling the crowd about a vision she had of impending doom.|
Spam|unsolicited commercial e-mail sent to a large number of addresses|The spam folder inside the email will allow the user to delete all unsolicited mail in one-click.|
Span|the full extent of something from one end to the other|The span of the woman’s hips was so wide that it was hard for her to find blue jeans to fit.|
Spangle|a little flat shiny piece of metallic decoration commonly sewn on clothing|Each spangle of the 500 spangles glistened in the sunlight from the young girl’s sparkling vest.|
Spanish|related to the people, culture, or language of Spain|Baroque is a type of Spanish architecture developed in Madrid during the 16th century.|
Spar|to fight with the exchange of physical or verbal blows|As they continued to spar back and forth, the political opponents both firmly held onto their positions.|
Spare|replacement or additional|Since we had a spare room available in our home, we housed a couple who was displaced from the hurricane.|
Sparing|showing mercy or pardoning someone|The Queen of Hearts never considered sparing anyone in Wonderland and screamed “Off with their heads” any chance she got.|
Sparingly|in small amounts|Use salt sparingly unless you want to increase your risk of having high blood pressure.|
Spark|a trigger or stimulus|One protest in the east of the country was a spark that set off a chain of demonstrations throughout the nation.|
Sparkle|shine; glitter|A sparkle in the princess’s bright eyes let the visiting prince know that she was interested in him.|
Sparse|thin; inadequate|With only a sparse supply of weapons, the villagers were worried they would not survive the attack.|
Spartan|reflective of vast self-denial|The décor in my apartment is spartan because I don’t have a lot of money for furnishings.|
Spasm|contraction of a muscle|Hiccups are usually due to spasm created by the diaphragm.|
Spasmodic|occurring in an erratic manner|Hopefully the medicine will control the number of spasmodic outbursts Henry has in class.|
Spat|to quarrel or argue briefly|Most couples make it through their first spat just fine.|
Spate|a series or large amounts of|A recent spate of employee changes left the company with an entirely new staff.|
Spatial|pertaining to space and the relationship of objects within it|Donna has excellent spatial awareness of all objects in her proximity.|
Spawn|to generate or produce|Big earthquakes tend to spawn smaller aftershocks that continue to rock the area for several hours or days.|
Speak|to talk or say something|The student was too shy to speak in front of her peers, so she never answered questions in class.|
Speakable|able to be said or spoken|Shaina had such a fear of public speaking that she found the words written on her paper barely speakable.|
Speakeasy|an illegal bar or club that sold liquor during prohibition|A narrow staircase lead to a speakeasy where bar patrons were getting their fill of illegal whiskey.|
Speaker|someone who speaks or delivers speeches to a crowd|The speaker approached the stage and received a standing ovation from the crowd waiting to hear her speak.|
Speakership|a person that speaks formally to an audience, especially in a political forum|The speakership stood in front of the podium and prepared to address the other city council members.|
Speaketh|a form of the word speak|Joseph dare not speaketh his father’s name since his mother seemed to hate him now.|
Spear|to impale or pierce an object|The Native American used a long rod to spear the fish right out of the water.|
Spearhead|to lead an event or project|Coach Marsh will spearhead our country’s gymnastic teams in the 2020 Olympics.|
Special|a thing that is better or greater when compared with what is the norm|The young ballerina has a special talent that allows her to outshine all of the other dancers.|
Specialist|someone who is an expert or devoted to a particular area of study|Only a health care specialist may perform surgical procedures on the patients.|
Specialize|to mention specially; to particularize|The bakers specialize in catering for large parties.|
Specialty|an area of study or skill that a person is focused on or particularly good at|The chef’s specialty is Italian cuisine, but he also dabbles in French cooking.|
Speciation|an evolutionary process that produces a new species|Speciation led to a new species of fruit flies being formed through evolutionary means.|
Species|a specific class of plants or animals|Lewis and Clark discovered many new species of plants and animals while exploring the West.|
Specific|clearly defined or identified|The key to his success in portrait art was his ability to take each specific detail and transfer it to paper.|
Specificity|the quality of being both clear and precise|The specificity of the test is 100%, and there is no chance of a false positive.|
Specify|to state something clearly and accurately|Because my son gets lost a lot, I had to specify every turn he would need to take to reach the park he was visiting with his friends.|
Specimen|that which is taken as an example of something or a portion used for testing|Hopefully, the lab won’t find any cancer cells in the tissue specimen.|
Specious|seems correct or true, but actually wrong or false; deceptive|The intruder tried to give the authorities a specious excuse regarding his presence in the building.|
Speck|a small particle|A speck of dirt flew in the runner’s eye, making it difficult for her to focus on finishing the race.|
Spectacle|a gripping event|The priest was not impressed by the spectacle of the naked women on the stage.|
Spectacular|having a magnificent impression or appearance|At the end of the parade, the designer of the most spectacular float will win a trophy.|
Spectator|someone who watches or observes|The difficulty of gymnastics is easy to forget when you are a spectator watching the performance.|
Specter|the spirit of a deceased individual|The specter of my deceased mother haunts our family home.|
Spectra|bands of light, as seen in a rainbow, that are produced by separation of light|Spectra flowing through the prism appeared as bright as bands of rainbow colored light.|
Spectroscope|a instrument used to analyze and break up white light up into the visible light spectrum|The spectroscope was used to analyze the light of the planetary nebulas.|
Speculate|to form an opinion despite a lack of information or evidence|Since I do not know Jim and Karen, I cannot speculate on the reasons behind their divorce.|
Speculation|ideas or guessing based on faulty or incomplete information|Although he wasn’t one hundred percent sure who committed the crime, speculation led the police chief to hone in on a suspect.|
Speculative|based on a guess about the future|With the weatherman predicting a very icy weekend, many people are making speculative food purchases and filling up their pantries.|
Sped|moved in a fast manner|As he sped down the track, the fastmoving racecar driver was careful not to flip his vehicle.|
Speech|a formal talk delivered to an audience|James practiced his speech over and over so he wouldn’t be nervous on stage.|
Speechless|astonished; amazed|The unlikely hero’s selfless acts of valor left the onlookers speechless.|
Speed|the rate at which something is moving or able to move|Light moves at a much faster speed than sound which is why thunder is always heard after lightning strikes.|
Speedily|quickly|Compared to the tortoise, the hare ran speedily in the direction of the finish line.|
Speedometer|an instrument inside a vehicle that measures its speed|The speedometer goes up to 140 miles per hour, but I don’t dare drive that fast.|
Spell|to speak or write out the letters of a word in the correct order|The teacher taught the children how to spell each word by sounding out each of the syllables.|
Spellbound|mesmerized by something|The spellbound child wouldn’t turn away from the magician.|
Spelt|having written or named the letters of a word in the correct sentence|The spelling bee contestant spelt the word wrong and her opponent took away the trophy.|
Spelunker|someone who frequents and discovers caves|After the spelunker finished searching through Carlsbad Cavern for days, he finally had the information he needed to write his travel article.|
Spendthrift|an individual who uses money in an irresponsible way|Because the lottery winner was a spendthrift, he spent his winnings in less than a year.|
Spent|paid out money, time, or resources|We spent several thousand dollars buying furniture for our new home.|
Spew|to forcefully expel a large amount of something|The elephant gathered a great deal of water in its trunk so it could spew it at its offspring and help the baby clean itself.|
Sphere|an area of activity, expertise, or interest|Although she was not in his sphere of command, she still respected him as a leader.|
Spherical|round in shape|Placing the spherical lens cap on the camera, the photographer packed up for the day and headed back to her cabin.|
Spheroid|a 3-D elongated globe or ball shaped similar to an egg|As the spheroid came toward me, I realized that my friend was simply throwing me his pigskin football.|
Sphinx|a mythological creature with the head of a human and the body of a lion|The Egyptian Sphinx statue has the head of a pharaoh and the base of a lion.|
Spiel|a lengthy and extravagant speech or argument usually intended to persuade|The teacher gave his usual spiel about the importance of completing all assignments, but the students just yawned.|
Spigot|a device used to control the flow of liquid|Turning the spigot on the side of the building, the thirsty traveler rejoiced as water began to seep out from the faucet.|
Spike|a sharp rise or influx|A sharp spike in flu patients pointed to a looming epidemic.|
Spill|to cause liquid to overflow|The sippy cup is supposed to be leak resistant and not allow any liquid to spill from the lid.|
Spin|to whirl or twist around in a circular motion|The nutcracker dancers began to spin around, whirling to the beat of the music.|
Spindle|a thin rod or stick with a pointed end|The spindle on the record player dropped down and the needle skimmed the surface of the disc.|
Spindly|tall and thin|The dancer was tall and spindly, with thin legs that seemed to go up to her shoulders.|
Spine|the backbone or vertebral column|The young man is affected by scoliosis of the back, otherwise known as a curvature of the spine.|
Spineless|lacking courage or willpower|Critics condemned the government’s decision to back down from the war as spineless.|
Spineless|lacking courage or strength|The spineless banker was too weak and pathetic to admit that he was the one who had stolen the money.|
Spinet|a small, electronic organ that was popular in the 16th century|Pressing the keys on the spinet, the organ player had learned to enjoy the harpsicord as much has own instrument.|
Spinning|turning around in a circular pattern|The dizzy boy felt that his head was spinning after turning around several times.|
Spinous|having bristles or being spikey|Children were warned not to touch the spinous plant located near the playground because its thorns would hurt if they touched it.|
Spinster|a woman who has never been married, especially one past the typical marrying age according to social traditions|They call Mrs. Smith on Padding Lane an old spinster, but she never wanted to be married and settled down.|
Spiral|a curved shape that winds round and round to form a helix or coil|Twirling a single spiral of her hair, the damsel admired her luscious curls in the mirror.|
Spire|a top part or structure that tapers upward|This particular cathedral is known for its towering steeple which contains the tallest spire in the nation.|
