Column|a-pillar or post that stands upright and is shaped like a cylinder|Each column of the tall plantation home had lights wrapped around its cylindrical form.|
Comatose|unconscious and unable to communicate|The car crash victim was comatose and unable to talk while on the stretcher.|
Combat|ake action to reduce, destroy, or prevent|In order to combat global warming, we must try to recycle, waste less, conserve energy, and burn fewer fossil fuels.|
Combatant|an armed fighter|Carey loved hearing his grandfather’s stories about when he was a combatant in WWII.|
Combative|ready to fight; argumentative|As the angry patient became more combative, the nurse gave her a shot of medicine to help her relax.|
Combination|the result of the grouping together of several different things|The kids like to eat pizza that has a large combination of different toppings.|
Combine|to bring two or more things or activities together; to unite|For a quick breakfast I often combine milk with cereal.|
Combustible|something that is susceptible to igniting or being caught on fire|Paper is a combustible material that you could easily light on fire with a match or a lighter.|
Combustion|the process of burning|The combustion of leaves can lead to a forest fire if not handled properly.|
Comeback|a return to popularity, success, etc. after an extended period of obscurity|Shoulder pads went out with the eighties, but I think it's making a comeback.|
Comedy|professional entertainment designed to make the audience laugh, typically through jokes or satire|I prefer to watch comedy movies because I prefer laughing over being scared or involved in a suspenseful action scene.|
Comeliness|attractiveness; beauty|The vain woman’s mother kept insisting that comeliness is in the eye of the beholder, but the daughter insisted a good plastic surgeon is key.|
Comely|attractive to the eye|Jake offered to buy the comely blonde a drink.|
Comer|one showing promise of attaining success|Starting up a comer advertisement agency, it was obvious that the entrepreneur’s business was headed for success.|
Comestible|an item of food|An Italian based comestible, pizza is one of my all-time favorite foods.|
Comet|a celestial body, generally with a tail located in the solar system|Astronomers discovered a comet and as it comes closer to earth, it becomes apparent it may strike our planet.|
Cometh|a form of the word come that is third-person singular simple present indicative form but is archaic and rarely used|If you refuse to pay what you owe, to your door, the tax man cometh.|
Comeuppance|just punishment that someone deserves|The judge handed down comeuppance to the deserving rapist.|
Comfort|to relieve the distress or suffering of; to provide relief to|Ruth’s was able to comfort her best friend after her cancer diagnosis with her supportive words.|
Comical|funny; amusing|My husband found the show comical, while I just thought it was silly.|
Comically|in a funny or joking way|The class clown would answer questions comically usually by explaining a situation that could never happen.|
Comity|mutual courtesy and respect|Comity is hard to find in the office since all of the bankers seem to value cutthroat actions over respect.|
Command|to order someone to do something|The King will command the men to be executed and the orders will be carried out.|
Commandeer|to take control of something|When the police officer noticed his tires were punctured, he made the decision to commandeer a civilian’s vehicle.|
Commander-in-chief|the supreme commander in a country’s armed forces|The President of the United States is the Commander-in-chief of its armed forces, the supreme commander above all others.|
Commander|a person in control of a group of people, especially military groups|The commander ordered the troops to turn back and leave the area.|
Commandment|a divine rule handed down by God|Because he didn’t fall the commandment ordained by God, the sinner was sentenced to death.|
Commemorate|to do something special as a means of tribute or recognition |The general will commemorate the soldier’s act of heroism by presenting him with a medal.|
Commence|to get under way |Since the meeting will commence at three o’clock exactly, do not be late!|
Commencement|graduation ceremony in which diplomas or degrees are confirmed|Preparing her commencement speech, the Valedictorian wanted to find a moving quote to speak to her fellow graduates.|
Commend|to express approval of a person's achievements|As the principal of the high school, it is my pleasure to commend all of this year’s graduates for their achievements.|
Commendable|deserving honor, respect, or admiration|I find it commendable that the department store would agree to accept returned merchandise, 3 months after it was purchased.|
Commendation|an award or honor|Receiving a commendation in recognition of his volunteer services was the highlight of the fireman’s day.|
Commensalism|a relationship between two distinct organisms in which one of the things obtains a benefit of some sort and the other organism neither gains nor loses anything |A remora attaching itself to a shark for transportation purposes is a prime example of commensalism.|
Commensurate|in proportion; equal|You will get a salary increase commensurate with your additional responsibilities and work.|
Commentary|descriptive remarks based on someone’s viewpoint|Every commentary that was made after the woman’s speech was positive since she spoke so eloquently.|
Commerce|actions associated with selling and buying services and goods| E-commerce or electronic commerce involves the buying and selling of goods and services online.|
Commiserate|express or feel sympathy or pity|Until you have walked in his shoes, you cannot commiserate with him.|
Commission|an amount of money given as a payment from the company for completing a business deal|Once the saleslady rung up the multiple items at the retail store, she smiled because she would make a hefty commission from the sale.|
Commit|to make one’s self obliged to do something or bound to a promise|The man regretted his decision to commit himself to marriage and wished he had never taken his vows.|
Commitment|the act of dedicating yourself to a cause or activity; dedication|Passing tests in medical school is important, but one also requires commitment to see things through to the end.|
Committee|a group of people appointed or elected to work on project or study a problem|Each committee member was given a different task to complete for the upcoming Relay for Life Event.|
Commodious|spacious and convenient; roomy and comfortable|I finally found an inexpensive hotel with rooms that are commodious enough for the whole family.|
Common|happening every day or ordinary|A common activity for new mothers is to calm and soothe their crying babies since babies cry for many different reasons on a daily basis.|
Commonality|the condition of sharing certain characteristics|The twins have only one commonality; they both have bright red hair.|
Commoner|an ordinary person who has no special title and isn’t of royal blood|Because she was a commoner, no one expected that Cinderella would be the one to end up with Prince Charming.|
Commonplace|ordinary; not unusual|Even though my sister and I equally shared the car, it was commonplace for the car to be missing from the driveway.|
Commonsensical|based on sound reasoning or information|Though the information was commonsensical, some of the students still didn’t understand it.|
Commonwealth|an independent country, community or state|According to census records her home state is the fastest growing commonwealth in the nation.|
Commotion|noisy confusion|There was a commotion among the sheep when the dog broke loose from its leash.|
Communal|used to describe something that is shared by or available to all members of a specific community|The communal pool at the community center is open to everyone that lives in the neighborhood.|
Communicable|referring to a disease that can be transmitted or given to others|Any disease that can be transferred to another person, be it through touch, air travel, or blood, is considered communicable.|
Communicate|to share information or ideas through words, movement, or writing|The twins use their own language to communicate, one that even their own parents don’t understand.|
Communication|the ability or act of talking with another person either in person or through some other medium to exchange information|The campers were cut off from communication with their friends and family members when their cellphones lost service deep in the woods.|
Communism|a financial and political system in which the government controls all of a country’s major resources and distributes them according to need|One of the benefits of communism is free healthcare for everyone.|
Commute|to travel to and from work on a regular basis, typically from home|My commute takes me about twenty minutes every day, so if I want to arrive to work on time I have to wake up at least forty minutes before I have to be there.|
Commute|to travel a considerable distance between home and work on a regular basis|Because my place of work is so far away, I have to commute for over an hour every single day to make it to work and back home again.|
Commuter|a person who regularly travels a great distance to work|Jake wasn’t thrilled to become a commuter, but the pay was worth the hour and 15 minute drive from home.|
Compact|condensed; compressed|The compact wagon was much more condensed than a full-size SUV.|
Compaction|the process of making more compact or densely packed together|The soil that was added to the planter had to be light so that compaction wouldn’t occur and crush the roots.|
Companion|someone you spend a lot of time with|Sometimes, the best companion for an elderly man is an obedient and calm dog.|
Companion|a person who accompanies another person while traveling or doing other tasks|The service dog acts as a companion to the blind man and follows him everywhere he goes.|
Company|a person or group of people seen as pleasant or enjoyable to be around|My brother has always been exceptionally good company, since we are around the same age and grew up spending time together.|
Comparable|having features in common with something else|Finding a hotel with comparable amenities at half the price proved difficult for the travelers.|
Comparative|relative; in comparison to something else|Because they are the three major monotheistic religions, Islam, Christianity, and Judaism are comparative faiths.|
Comparatively|to a moderate degree when compared to something else|Mistreating others because you have a comparatively higher income is morally wrong.|
Compare|to note similarities between things|Auditors will compare the two files to see if they equal up.|
Comparison|the act of telling what two or more things have in common|A comparison of the two books showed that the main characters had a lot in common.|
Compartment|a separate division or section, often of a room, chamber, or container|The pyramid contained a secret compartment where the body of the pharaoh and all his possessions were stored.|
Compartmentalize|to separate and isolate things into compartments or categories|We are taught to compartmentalize our work and personal lives, but sometimes it is hard to separate the two.|
Compass|a round, arrowed device that always points north and is used to find direction|Explorers used the compass to find their way to the island.|
Compassion|awareness of an individual’s suffering|The woman’s compassion for others led her to become a nun.|
Compassionate|displaying concern and/or understanding towards other people|The compassionate man donated half of his yearly salary to local charities.|
Compatible|able to occur together or exist without conflict|While Fido is compatible with dogs, he does not get along with cats.|
Compatriot|somebody from one's own country|It put Juan at ease to be sitting next to a fellow compatriot on the plane trip from Spain to the United States.|
Compel|to press or force to have something done |Sometimes I have to compel my daughter into doing her chores by threatening to keep her allowance.|
Compelling|captivating; enthralling|The music was so compelling the snake stopped watching its prey and began to sway.|
Compendious|something that has been explained in a concise or brief way|The small book included a short and compendious overview of the history of Feudal Japan.|
Compendium|an assortment of items displayed as a set|The book is nothing more than a compendium of the author’s rants against the government.|
Compensation|that which is given as payment for a service or as reimbursement for a loss or expense |If the compensation doesn't allow me to pay my bills, then I'm not interested in the job.|
Compete|To try to win something such as a prize or award|On Friday, our team will compete in a race against a neighboring school.|
Competition|a challenge for an award or prize|When the spelling competition concludes, a prize will be given to the best speller.|
Competitive|having a strong desire to win or be the best at something|Because she’s so competitive, the tennis player can’t stand for someone else to win a match.|
Competitor|one who takes part in a contest or competition|Manuel was the only competitor that had ever been a part of the race before.|
Compilation|a collection|A compilation of family photos was on display all across the living room wall.|
Compile|to bring together items and put them in one set or collection|The librarian will compile popular books by African American authors and put them in a special area for Black History Month.|
Complacency|a feeling of self-satisfaction that makes one unaware of one’s environment|Because of the complacency of the guards, enemy spies were able to sneak into the castle.|
Complacent|pleased; overly content|I am rightfully not complacent with low quality service.|
Complain|to make negative remarks about someone or something often|The students complain about all the extra homework their math teacher gave them over winter break.|
Complaint|a grievance, problem, difficulty or concern; the act of complaining|I intend to make a formal complaint against my manager to Human Resources.|
Complaisant|marked by an inclination to please or oblige|Marsha’s complaisant character made her the perfect servant.|
Complete|to finish; to conclude; to reach the end |The investigation into the store robbery is complete once the criminal confessed.|
Complex|difficult and complicated|A complex problem surfaced during the faculty meeting when there were not enough staff members to serve food that day to the hundreds of customers who showed up.|
Complexion|the tone and look of the skin of someone’s face|Her smooth complexion made the model irresistible to every cosmetic company who saw her face.|
Complexity|the state of being difficult or complicated|Joshua became quite nervous when he noticed the complexity of the math problems on his final exam.|
Compliant|observing the requirements and rules|The teacher was shocked when her normally rebellious class became compliant.|
Complicate|make something more difficult or confusing by causing it to be more complex|On shows like Chopped and Cupcake Wars, judges like to complicate the challenge by adding an exotic ingredient that many chefs haven’t used before.|
Complicated|difficult and involving many different parts|The first cake recipe was too complicated, so I decided to choose a simpler one.|
Complication|a difficulty or problem|The surgery was completed with only one complication and that difficulty was quickly overcome.|
Complicity|the condition of being involved in an act of wrongdoing|Your complicity in the crime is probably going to earn you five years in prison.|
Compliment|a few words of praise: saying that someone or something is good in some way|I just wanted to compliment you for the wonderful speech you gave tonight.|
Comply|to obey or be in agreement with a policy or rule|The man was arrested because he refused to comply with the airline’s no smoking policy.|
Component|a small section of a bigger part of a whole thing|The only component of the sandwich that I do not like is the tomato, but the turkey, lettuce and mayonnaise are fine.|
Comport|to fit with or act in a certain fashion|Because the children do not comport well in a formal dining atmosphere, we have placed them at a kids’ table in the kitchen.|
Comportment|conduct; manners|Because my brother lacks good comportment, he’s probably going to offend someone during the wedding banquet.|
Compose|to put something together, like a letter, song, poem, speech, etc.|Mozart would compose many famous musical pieces in his lifetime.|
Composed|calm and showing no signs of nervousness|Trying to remain composed as she approached the judges, the beauty contestant took a deep breath and gave a sweet smile.|
Composite|comprised of various elements |The composite test score is the sum of the math and vocabulary scores.|
Compost|decayed material (i.e., leaves, food peelings) that is used as a fertilizer|Al created a compost pile in his garden and used the decaying leaves and grass to help his trees grow.|
Compound|a property that has multiple buildings in one area|The entire compound was secured by fences and security systems that served to protect all of those inside.|
Compound|a thing that is composed of two or more separate parts|The compound sentence was made of two different phrases.|
Comprehend|to mentally grasp the meaning or reason behind something|Since the text was written in a foreign language, I could not comprehend its meaning.|
Comprehension|understanding; grasp of knowledge|Comprehension of the passage required the student to read the text several times.|
Comprehensive|comprising a wide range of things|Because I want the car completely repainted, I have purchased the comprehensive auto package.|
Compress|to flatten something by pressure|Wearing a girdle to compress the pudge on her stomach, the vain woman was much happier with a tummy that appeared flat.|
Compression|the action of squeezing something into a smaller form or space|Compression occurs when you squeeze something large into something small, like a pillow.|
Comprise|to be made up of |Women and children comprise seventy percent of the hospital’s patients.|
Comprised|to be formed or made from|Rick’s sculptures are comprised of copper and aluminum.|
Compromise|an arrangement reached when two parties agree to make allowances|In a monetary compromise, the debtor agreed to pay the bill in full if the lender gave him a payment plan.|
Comptroller|a person in charge of supervising the quality of the accounting and financial reporting of a corporation or public body|The comptroller released an audit that outlined all of the discrepancies he found in the mayor’s office’s financial records.|
Compulsive|uncontrolled or reactive and irresistible behavior|My wife is a compulsive shopper spending more than what we can afford.|
Compulsory|not having an option; required|Because education is not compulsory in all countries, there are many children who do not attend school.|
Compunction|anxiety arising from awareness of guilt|The serial killer showed no compunction when his guilty verdict was announced.|
Computation|the act of mathematically calculating something|Computation of the math problem was too difficult to take on without a calculator.|
Compute|to calculate or work out|In order to compute the correct numbers, Leanna needed a calculator.|
Comrade|one who shares an experience or duty|Police officers came from across the country to gather at the funeral of their comrade.|
Con|to trick or mislead someone|The traveling salesman made good on his promise to con every housewife in the neighborhood.|
Concatenation|taking two separately located things and placing them side by side so that they become two things|The student’s concatenation of the words ‘air’ and ‘plane’ formed the word airplane.|
Concave|shaped in an inward manner like a bowl’s interior|While a convex lens turns outward, a concave lens bends inwardly.|
Conceal|to put out of sight or hide from scrutiny|Danielle tried to conceal her bruises with skin-colored foundation.|
Concede|to admit something is true or to admit defeat in a contest|Since he was trailing behind, the politician decided to concede the election to his opponent.|
Conceit|arrogant pride in oneself|There was so much conceit in his voice I couldn’t help but wonder if he swooned over his own image in the mirror every morning.|
Conceited|holding an overblown view of one’s assets|The conceited man would not stop talking about himself.|
Conceivable|capable of being conceived or imagined; possible; credible; thinkable.|It is quite conceivable that in 100 years from now, the world will be an unrecognizable place, due to the rapid advancements in technology.|
Conceived|imagined; visualized|The idea for the voice app was conceived while the inventor’s father was in the hospital.|
Concentrate|to focus all of your attention or mental effort to the thing you are doing|With his sister’s music blaring in the background, it was impossible for Dante to concentrate on his piano lesson.|
Concentration|the act of focusing one’s attention on something|My concentration was disturbed by the sound of a lawnmower outside my office window.|
Concentric|sharing an axis or center|The two circles are concentric because they share a center location.|
Conception|the birth of an idea or plan|It was obvious from the conception of the fundraiser the event would not be profitable.|
Conceptual|of, or relating to concepts or ideas; existing in the imagination|A good writer uses conceptual thinking to produce his work.|
Conceptualize|to come up with the idea or vision for something|During the meeting, we were asked to conceptualize a marketing plan for our client.|
Concern|a specific worry or distress|One concern of the mother is that her child seems not to be gaining much weight.|
Concert|a musical performance put on by one or more musicians/singers|I lost out concert tickets, so we won’t be able to go to the musical we’ve been dying to see.|
Concerted|in group agreement; working as a team|A concerted effort from community residents led to the formation of an effective neighborhood watch.|
Concession|an item or privilege that is given|Since the developer could not give the landowner his desired concession, he was not able to buy the land for the new subdivision.|
Conciliate|make calm and content; placate |Before mediating between the two parties, the judge attempted to conciliate the plaintiff to prevent unnecessary litigation.|
Conciliatory|To regain (friendship or goodwill) by pleasant behavior; to reconcile|The mediator made a conciliatory statement which helped the two parties find common ground.|
Concise|short; not lengthy|The concise exam was greatly appreciated by the exhausted students who had studied all night for the test.|
Conclave|a private meeting in which the discussions are kept secret|The conclave of politicians was held on a Friday, giving the attendees the weekend to mull over the sordid details of their discussions.|
Conclude|to come to a decision or judgment|The teacher will probably conclude I am not listening to her lecture because I have my eyes closed.|
Conclusion|the end, finish, or finale of an event|The conclusion of our meeting came at seven o’clock, an hour after we had started and a full thirty minutes longer than we had planned.|
Concoct|to make something using cleverness or ability|My mother is a talented chef who can concoct a gourmet meal out of sandwich meats.|
Concoction|something created from scratch|I could not wait for the bartender to finish my delicious concoction.|
Concomitant|happening at the same time as something else|Because the contractor and decorator agreed to concomitant work schedules in the final stages of construction, the house was ready to show well ahead of time.|
Concordance|agreement; accord|The newest scientific data was in concordance with the last test and also the one before that.|
Concourse|a large open space inside or in front of a public building where people can gather such as a train station or airport|Once travelers pass through the airport security screenings, they’re allowed to enter the concourse.|
Concrete|solid, real, or tangible, something physical that can be touched|While thought may not be tangible, the human brain is a very concrete thing that can be touched and felt.|
Concubine|a woman who lives with a man as a mistress but has a lower status than his wife/wives|Though he loved his concubine the most, the king decided long ago just to have one wife.|
Concupiscence|an intense desire, often describing a sexual craving|Jared shouldn't get married until he can rein in his concupiscence and control his sexual cravings.|
Concur|to agree with something|With no other facts on hand, I can only concur with your statement.|
Concurrence|when things are happening at the same time|During the sentencing, the judge ruled that the guilty party’s two sentences would run in concurrence and be served at the same time.|
Concurrent|occurring at the same point in time|Since my anniversary and my mother-in-law’s birthday are both on August 12, the two events are concurrent.|
Concussion|the result of a really hard hit to the head, causing a temperary loss of function|Falling onto the hiker’s head, the boulder caused a concussion.|
Condense|to decrease size or volume|John managed to condense his education and previous job skills to one page on his resume.|
Condescending|showing that you are more important than others|Rick said this condescending remark at work today: "I'm better than all of you!"|
Condign|fair, fitting, and deserved|The judge’s job was to make sure that the sentence was condign for each crime.|
Condiment|a sauce such as mustard or ketchup that adds flavor to food|Condiment packets were handed out to every person who wanted ketchup on their hotdog.|
Condition|a disorder or illness|Although she tried to hide her skin condition under make-up, the girl’s eczema caused her to be picked on in class.|
Condone|to accept and allow|We will not condone disorderly conduct at church.|
Conducive|to cause or produce something|The declining number of available positions are conducive for the highest unemployment rate in decades.|
Conduct|the way one acts or carries themselves|Because we are going to be visiting a nursing home, we hope all of you students will conduct yourselves in a kind and polite manner.|
Conduction|the process by which sound waves travel through another material|The conduction of sound through the air is what allows us to hear all of the noise around us, since we wouldn’t hear anything if the sound didn’t travel to our ears from its source.|
Conductive|associated with a material that carries heat or electricity|The conductive wiring may feel warm to the touch because of the electricity it’s carrying.|
Conductor|a person who is in charge of a group of performers or ticket collection on a train|During the performance, pay attention to the conductor to ensure you’re playing in tune with other orchestra members.|
Conduit|a means of getting something to another place or person|For many slaves, the underground railroad was a conduit of freedom.|
Confabulate|to chat or talk to someone in an informal way|Chatty Cathy will confabulate with anyone willing to hold a conversation with her.|
Confederacy|a group that has formed to participate in an activity or to work towards a common cause; term generally used in the United States to refer to the Southern states during the Civil War period |To unite against union forces, the Southern states formed a confederacy.|
Confer|to discuss|Since the doctors are unfamiliar with my symptoms, they will confer on a diagnosis.|
Conference|a formal meeting in which people gather to talk about specific ideas or problems|A conference was held last weekend to teach struggling writers how to improve their skills.|
Confess|to admit that you are at fault or have committed some wrongdoing|Many people go to a priest to confess the things that are wracking them with guilt, and by doing so alleviate themselves from that guilt.|
Confession|an admission of something one has done that was wrong or illegal|The kid’s killer confession shocked the small town who never thought him capable of such a crime.|
Confide|to share information in secret|I often confide my secrets to my best friend because I know she will not tell them to anyone.|
Confidence|a belief that you can trust something or someone fully|The wife’s confidence in her husband was shattered after she discovered his affair.|
Confidentiality|rules regarding the keeping of something secret or private|Even with confidentiality rules in place, company workers still shared private information.|
Confinement|being locked inside or forcibly kept inside somewhere and not allowed to leave|By consenting to confinement in an institution, the patient hoped that she would finally get the medical treatment she so desperately needed.|
Confines|boundaries or limits of a space|It did not take the dog long to escape the confines of the backyard.|
Confirm|verify truth or accuracy|Bank tellers tried to confirm the man’s deposit but showed no record of the transaction.|
Confirmation|confirmation is the action of confirming something|A confirmation code was sent by email verifying the online furniture purchase.|
Confirmed|describing someone who is firmly established in a set of ways or practice|The young man is a confirmed bachelor, having been single for almost three years now and not looking to marry anytime soon.|
Conflagration|conflict or war|It seems as though the conflagration in the Middle East has been going on for centuries.|
Conflate|to blend two or more things into one whole|Every time she gets a cold, Sandy seems to conflate it with some other illness.|
Conflicting|contradictory; inconsistent|Laughing while she cried, the woman had conflicting emotions about her daughter leaving for college.|
Conform|to fit in with standard practices or behaviors|Because of Janet’s low self-esteem, she tried to conform alongside the cool kids by imitating their fashion styles.|
Conformist|an individual who follows accepted practices|As someone who refuses to be a conformist, I go out of my way to take the path less frequently chosen.|
Confound|to mix up or confuse|If the nurse does not read the labels, she will confound the medications and possibly harm patients.|
Confrere|a fellow profession or fraternity member|The student quarreled with his confrere about who would be president of the fraternity.|
Confront|to face or stand up to|After arriving home to a broken window, the woman decided to confront the babysitter about what happened.|
Confrontation|the act of confronting or challenging another especially face to face|She had a heated confrontation with her parents over homework.|
Confucianism|an ancient philosophy of respect and kindness based on the teachings of Confucius|Confucianism promotes the idea that people should be both virtuous and honest.|
Confuse|to mix up; to puzzle; to bewilder|I always confuse my neighbor’s twin girls as they look and dress alike.|
Confusion|the state of uncertainty and not understanding what is going on|As a way to avoid confusion while traveling, Johnny made sure to write down clear directions.|
Confute|to prove something wrong|Certain that she could find evidence, the young lawyer set out to confute the witness’s story against her client.|
Congeal|to change from a liquid to solid state|They refrigerated the liquid gelatin so it would congeal before they ate it.|
Congenial|pleasant and enjoyable|Mark is a congenial host who always makes everyone feel welcome.|
Congenital|existing since birth|Due to a congenital heart condition that ran in their family, the parents were worried about their unborn child.|
Congeries|a jumbled collection of things|The woman’s spare room was littered with a congeries of boxes and bags.|
Congested|crowded and blocked|Moving through the congested city, the cars honked their horns loudly as pedestrians darted across the roadway.|
Congestion|accumulation; buildup|My doctor gave me antibiotics after my nasal congestion turn into a sinus infection.|
Conglomerate|a big corporation composed of several small firms that operate as a single business|The billionaire’s conglomerate includes restaurants, convenience stores, and a chain of hotels.|
Congregate|to gather as a unit or group|During the summer teenagers often congregate at the beach.|
Congressional|relating to congress|A congressional convention was held to discuss federal policies.|
Congruity|harmony or agreement|Having worked together for years, the congruity of the team made them a shoe-in for the state competition.|
Congruous|in agreement|Expecting her mother to be congruous with her plans to move out, the young woman was shocked when she disapproved|
Coniferous|a tree or bush bearing cones and green leaves that do not fall in the winter|Even though the tree was classified as coniferous, it had a peculiar color that was far from evergreen.|
Conjectural|based on thoughts and ideas not backed by evidence; hypothetical|The prosecutor knew the jury would have doubts about his conjectural theory of the crime.|
Conjecture|an opinion or idea formed without proof or sufficient evidence|The jury rejected the attorney’s conjecture about the defendant’s motive because of a lack of evidence.|
Conjoin|unite; combine|With only one set of handcuffs, the officer had to conjoin the two suspects.|
Conjointly|together|As the octopus began seize its prey, all eight tentacles worked conjointly to finish the job.|
Conjugal|of or relating to marriage, or the relationship of spouses|The inmate received weekly conjugal visits from his wife.|
Conjugate|to combine or fuse two things together, typically referring to words such as ‘can’t.’|In the English language, we conjugate many different words for convenience, such as ‘won’t’ for ‘will not.’|
Conjugation|the process of changing a verb’s form to show person, tense, number, etc|In this form of conjugation, the word ‘help’ changes to ‘helped’ to show the past tense.|
Conjunction|the act of joining two or more occasions together|In April a city in Georgia will sponsor a city clean- up to embrace a more environmentally-conscious perspective called Living Green in conjunction with Earth Day.|
Conjuncture|a combination of events that create a crisis|A conjuncture of highly unlikely weather events leads to a devastating spring snowstorm.|
Conjuration|a magic spell|The witch’s conjuration led to many demons being released on Halloween.|
Conjure|to bring into existence, sometimes by magic|The magician was able to conjure a rabbit out of his empty top hat.|
Conjured|summoned unexpectedly as if by magic |The woman conjured the evil spirits to get revenge upon the men who killed her daughter.|
Conjurer|a person who practices magic|The conjurer was able to turn the man into a monkey with a wave of her wand.|
Connate|inherit beliefs or ideas existing in a person since birth|The boy had a connate love for music since he was born.|
Connection|one that links things together|A connection from the computer to the wall allowed the secretary to access the internet.|
Conniption|a fit, fuss, or tantrum|My father had a conniption when he realized that I had not made all A’s for this semester of school.|
Connivance|the act of allowing an illegal action to take place|The clerk’s connivance allowed her to watch idly by as her supervisor stole thousands of dollars from the bank.|
Connive|to conspire or plan|The billionaire did not believe his greedy children would connive to murder him.|
Conniving|discreetly working to complete a dishonest task|Alan’s wife is a conniving woman who only married him for his money.|
Connoisseur|an expert on a particular subject|Because the psychologist talks to many individuals, she considers herself to be a connoisseur of people and their relationships.|
Connotation|suggested or implied meaning|Even though skinny technically means the same thing as slender, it has a connotation that is less favorable.|
Connote|to imply something in addition to what is apparent |To an atheist, the image of a cross does not connote anything other than a perpendicular design.|
Conquer|to overcome and take control of something|Members of the group decided to rebel after seeing that no one was listening to their ideas.|
Conqueror|a person who takes control of a place by force|Alexander the Great was a conqueror who dominated Greece, Egypt, and Persia.|
Conquest|victory gained through combat|The diner’s conquest was to eat the entire 64 ounce steak in one sitting.|
Consanguinity|a familial relationship or close connection|The results of the blood test showed there was no consanguinity between Ed and the man he had always referred to as his papa.|
Conscientious|working hard and careful to do things well|Carrie is a conscientious worker who completes every task.|
Conscious|aware|I became conscious of the crisis when the photographs of the terrorist attack were displayed on the news.|
Consciously|doing something deliberately, with awareness|While on a diet, the woman chose every meal consciously.|
Consciousness|cognition, awareness of the mind of its own existence in the world|The stream of consciousness is what allows us to continue to think, and constantly question our place in the world.|
Conscription|the system of forcing individuals to serve in the military|Because of John’s moral beliefs, he refuses to take part in the conscription that would require him to bear arms.|
Consecrate|to announce something is sacred or devoted to a specific purpose|After high school, the young men will consecrate their lives to the church and serve as missionaries for two years.|
Consensus|general agreement about something|When the judge learned the jury had not reached a consensus on the defendant’s guilt, he sent the group back into the room for further discussion.|
Consent|permission for something to happen|Fraud charges were filed after the woman used a friend’s credit card without her consent.|
Consequence|something that occurs as a result of an action|My daughter’s consequence for breaking curfew was a loss of her mobile phone privileges for two weeks.|
Consequent|happening as a result of something|Because it was last minute, our reservations were consequent on restaurant availability.|
Consequential|significant; important|The partial footprint was consequential in solving the case.|
Consequently|occurring as a result of an action|At the hotel, we take safety very seriously, and consequently, we have security officers on duty twenty-four hours a day.|
Conservation|the smart consumption of organic resources|Since we only have so much water on this planet, it is important we devise conservation methods now.|
Conservationist|a person who advocates for the preservation and protection of the environment|The conservationist wrote letters to the loggers urging them to stop cutting down the trees.|
Conservatism|a political philosophy that favors traditional values and a small government and opposes social change|Countless Republicans showed up to the forum where they discussed conservatism and the perks of small government.|
Conservatory|a school that focuses on music and other arts|The conservatory applicant’s style of music made her a shoe-in for admission.|
Considerable|of a decent size or to a great extent|After receiving a considerable number of calls each day, the district attorney’s office has decided to reopen the investigation.|
Considerate|concerned about the feelings and rights of other people|The considerate man held his umbrella over the elderly woman’s head.|
Consideration|careful thought or deliberation|You must take the price into consideration before buying a car from the dealership.|
Consign|to pass something to another individual so the item can be sold|To make extra money, some women in my neighborhood consign their used baby garments to a clothing store.|
Consignment|goods sent for sale|We purchased a vintage sofa on consignment.|
Consist|to be made up of or composed of|Many sandwiches consist of peanut butter and jelly, but you can also make them with ham or cheese and a number of other ingredients.|
Consistency|texture; feel|After jaw surgery, the consistency of the patient’s food could not be solid.|
Consistent|always acting or behaving in the same way; unchanging|He was consistent, always arriving at the diner at exactly 9:15 every morning.|
Consolation|comfort or reward given to someone who has lost something or someone |The court’s decision to award me two million dollars in damages was no consolation for the loss of my husband.|
Console|to provide a person with comfort when he or she is struggling emotionally|I tried to console my best friend when her husband died.|
Consolidate|to put together|To save money on airline fees, my husband and I will consolidate our clothes so they fit in one suitcase.|
Consolidation|the act of combining several actions into one|The consolidation of all our household debt into one loan was a wise choice.|
Consoling|comforting and calming|After the child began to cry due to being lost, an older woman was consoling him by telling him that everything would be fine.|
Consonance|harmony, compatibility or agreement|The consonance of the committee was clear when they voted to unanimously elect a new treasurer.|
Consort|a partner or associate with whom one shares something|My consort will finish the presentation for me.|
Consortium|a group of individuals, businesses, or associations that work in a coordinated effort|When the consortium of doctors from across the globe meet, its members will discuss the best way to contain the virus.|
Conspicuous|very easy to notice|It would be inappropriate for you to wear such a short conspicuous dress to your father’s funeral.|
Conspiracy|the act of at least two individuals working in a covert manner to complete a task|The group was arrested for conspiracy to kill a law enforcement officer.|
Conspirator|part of a group that agree to do an unlawful or unethical act|The evil conspirator watched with glee as his harmful plan unfolded.|
Conspiratorial|suggesting something private is being confided|At one time or another during the game, each team will form a conspiratorial huddle to discuss its game strategy.|
Conspire|to make covert plans to perform an illegal or bad deed|Some poor people believe politicians conspire to keep them in dire financial straits.|
Constant|nonstop; ceaseless; for a long duration|The Earth is in constant motion as it spins on its axis.|
Constellation|a collection of stars that form an identifiable pattern|People can use the figure shaped by a constellation to recognize specific stars.|
Consternation|a feeling of worry, shock, or fear - often happens when something unexpected happens|I sleep in consternation not knowing where my keys are.|
Constituency|voters that elect representatives based on area or interests|Most of the constituency in California voted for the democratic candidate.|
Constitute|to be equal to something|While Greg is a key player, he does not constitute the entire football team.|
Consitutional|having to do with the constitution|Owning a firearm is considered a constitutional right.|
Constrain|to restrict, limit or hold back|Dave purchased a play pen to constrain his energetic puppy while he was at work.|
Constraint|a limitation or restriction|Jordan felt the constraint of handcuffs pressing tightly around his wrists.|
Constrict|to narrow or reduce|Because I am allergic to peanuts, any contact makes my throat constrict.|
Construct|to build something|A crew was hired to construct the home and we hope it will be built by Christmas.|
Constructive|carefully considered and meant to be helpful|The judge’s comments were very constructive to the young singer.|
Construe|to clarify what something means|We were all amazed by the detective’s ability to construe logic out of the killer’s strange riddle.|
Consul|a bureaucrat selected by a country’s government to live in a different nation and protect the sending country’s interests and citizens|The diplomat will work as his nation’s consul by supporting the concerns of his homeland while residing abroad.|
Consulate|the office or building where a consul works|While traveling to China, I decided to address my issues at the consulate.|
Consult|to seek advice from someone with professional expertise|I decided to consult with a carpenter regarding the deck I planned on building in my backyard because I needed professional advice.|
Consultant|someone, usually a professional, who gives advice on a particular subject|We hired a lawyer as a consultant for our case since we have no legal experience of our own.|
Consultation|a conference for the exchange of information and advice|When my jewelry was stolen, I had a consultation with a lawyer to get his advice about whether or not I should sue my neighbor for the robbery.|
Consultive|related to consultation or professional advice|While it is not what they do primarily, many still consider a psychologist to be a consultive profession.|
Consume|to eat or drink something|The dog was always in a rush to consume her food, swallowing the meat in one big gulp.|
Consumer|an individual who buys services and goods for his or her own use|As a consumer, I try and buy inexpensive products.|
Consumerism|an economic theory based on the idea that spending money/selling lots of goods is good for the economy|Because America is based on consumerism, the economy relies on the hustle and bustle of sales.|
Consummate|extremely skilled|Phil is a consummate golfer who earned over eight million dollars in tournaments last year.|
Contact|to meet or communicate with someone|The teacher tried to contact her student’s parents, but couldn’t get them to answer the phone.|
Contagion|an infection or other medical condition that is passed through both direct and indirect contact|Washing your hands is one of the most effective ways to stop the spread of the fatal contagion.|
Contagious|capable of spreading a disease|I was not allowed to visit the hospital because my grandfather was contagious.|
Contain|to hold or enclose|The gardens on the northside contain roses, lilies, as well as some beautiful wildflowers.|
Containment|the action of restricting or controlling a dangerous person or thing|Containment is the goal of the firemen as they try and control the forest fire.|
Contaminate|to make something dirty, dangerous or less pure|A boil order would be put into effect because an unknown substance had begun to contaminate the local water.|
Contemplate|to consider something |My best friend’s suicide caused me to contemplate my own happiness.|
Contemplating|carefully thinking about something|After seeing his girlfriend’s offensive text, he was contemplating a breakup.|
Contemporaneous|taking place during the same period of time|The dancers have practiced for months to get their movements in sync and contemporaneous.|
Contemporaneously|in the same period of time|Both the Francisco Library and the Benjamin Art Museum opened contemporaneously with similar works.|
Contemporary|quite recent|While young people tend to prefer contemporary music, the older generation prefers to listen to music from the 1970’s and the 1980’s.|
Contempt|the feeling of intense dislike and a lack of respect for someone/something|Because Abby came from a wealthy family, it was not surprising she looked at homeless people with contempt.|
Contemptible|worthy of contempt|The judge sentenced the contemptible man to a lifetime in prison.|
Contemptuous|showing or feeling deep hatred for someone or something|Because he was often in pain, my grandfather was a contemptuous old man who looked down upon practically everyone.|
Contender|someone or something that opposes another in the pursuit of the same goal|In a game of basketball, each team is a contender to the other, playing against each other for victory.|
Content|in a peaceful, happy state|Though the steak wasn’t perfect, the satisfied customer was content with his meal.|
Contented|happy and satisfied|A contented smile crossed her face when she heard that she was selected for prom queen.|
Contention|a dispute between groups or individuals|Does anyone know the point of contention that started the fight between Jim and Bob?|
Contentious|causing or likely to cause an argument|The author wrote a contentious novel which caused a great deal of unrest.|
Contentment|a feeling of being happy and satisfied|After her near death experience, she focused on contentment with life.|
Contestant|someone who takes part in a contest or competition|If you are taking part in a competition, such as a game show on TV, you are a contestant.|
Context|the setting in which something occurs|Without context, many conversations that you overhear only a part of make no sense whatsoever, and can often be kind of weird.|
Contextualize|to put something in proper perspective|If a friend enters a conversation you are having halfway through it, you may have to contextualize it before he knows what you are talking about.|
Contiguous|used to describe things that touch each other or are next to each other |Susan chose her condominium because she loved the fact its layout included a large playroom for her growing family.|
Continence|the ability to restrain oneself, including one’s bodily discharges|During a rare moment of continence, Tom kept his smart comment to himself.|
Continent|one of the seven large masses of land on the Earth|Each separate continent used to be part of one giant landmass called Pangea.|
Continental|forming or belonging to a continent|I have a continental lineage, considering that every single one of my ancestors was born in Europe.|
Contingency|an event that could occur|The city’s evacuation plan is designed to be effective in case of any contingency that necessitates a hasty withdrawal.|
Contingent|depending on whether or not something else occurs|The job offer was contingent upon the return of a clean background review.|
Continual|happening over and over again|Continual calls from bill collectors led the irritated woman to change her phone number.|
Continuance|a postponement or delay, especially in a legal proceeding|The defendant’s attorney asked for a continuance so that he would have two weeks to prepare for trial.|
Continuation|the action of carrying something out over a period of time|Continuation of the movie will happen right after the commercial break.|
Continue|to remain so it is going on and on|“We will continue writing our essays for the next ten minutes since half the class isn’t finished,” the teacher told her students.|
Continuous|going on and on without interruption|Because of the water leak, a continuous stream sprayed out of the ground for several hours.|
Continuum|something that keeps on going, changing slowly over time|The space-time continuum was studied by those interested in time travel.|
Contorted|twisted in a forceful manner|The python contorted around its intended victim.|
Contortion|a bent position or shape |The gymnast’s contortion allowed us to see the full extent of her flexibility.|
Contour|to mold something into a specific shape|The artist made sure to contour the lines on the painting to make the animal appear more real.|
Contraband|items that are illegally transported|The inmate’s wife was arrested for trying to bring contraband into the jail.|
Contract|a written or spoken agreement|After signing the rental contract, the tenants quickly regretted the agreement.|
Contradict|to disagree with what is being stated|Surprisingly, the lab results contradict with the physician’s diagnosis.|
Contradictory|opposite or logically inconsistent|The contradictory law makes no sense because it outlaws the act in one part and allows it in another.|
Contradistinction|distinguishing things by noting the contrasts or differences in them|The human mind is notorious for using contradistinction, often distinguishing people and objects by the difference they bear to others.|
Contrarian|a person who rejects the majority and takes an opposing view|The politician took a contrarian stance and opposed the bill supported by most of the members of his party.|
Contrarily|in an opposing manner|My wife acted contrarily to my wishes when she allowed our daughter to go to a party without asking me first.|
Contrary|not compatible with a position or nature; in opposition |Contrary to my political rival’s statement, the data reveals crime has not increased in this country.|
Contrast|to differ greatly |Even though Kurt is going to love his new job, his salary will contrast negatively with the large income associated with his former position.|
Contrastingly|at odds with something or the polar opposite of it|The two friends are so contrastingly different that it is a real surprise that they get along at all, though they do say that opposites attract.|
Contravene|to act against a rule or law|Because your actions contravene school policy, you're being suspended for ten days.|
Contribute|to donate something to a cause, whether it be time, money, or ideas|Ariana Grande and several other artists came together to contribute to charity concert for victims of the Manchester terrorist attack.|
Contribution|a gift or payment to a common fund or collection or the part played by a person or thing in bringing about a result or helping something to advance|The grocery store cashier asked the customer if she would like to make a contribution to the American Heart Association.|
Contributor|someone or something that gives aid to a cause or goal|I am a contributor to the charity that I support, giving it a significant monetary donation every month.|
Contrite|feeling or showing remorse or regret|The local news was noticeably contrite and apologized to viewers for the countless on-air technical difficulties.|
Contrition|the state of feeling remorseful or sorry for what one has done|The defendant pled guilty to the crime and expressed heartfelt contrition for the things he done.|
Contrivance|something contrived, as a mechanical device or a clever plan |While we thought the movie was supposed to be an insightful documentary, it was actually nothing more than a political contrivance created to stir hate among ethic groups.|
Contrived|unnatural or fabricated |Jim made the contrived confession after the police threatened him.|
Control|to exercise influence over; to suggest or dictate the behavior of |The whole operation is under control of the production manager.|
Control|to influence or direct people’s behavior|The overbearing mother liked to control her children’s behavior and wouldn’t let them do anything without her permission.|
Controllable|able to be controlled; manageable|“Asthma is very controllable, if you’re following the asthma guidelines and taking medication as needed.”|
Controversial|something that is the subject of typically heated public disagreement|Many political topics are controversial subjects precisely because they appeal to one party demographic or the other.|
Controversy|a heated conversation between two parties with different opinions|The controversy around same sex marriages continues to be a trending topic on Twitter.|
Contumacious|rebellious against laws or those in authority|Because the contumacious student refused to obey the principal’s instructions, he was suspended from school.|
Contumelious|insulting; Showing a lack of respect or rudeness|Offended by her niece’s contumelious behavior, Linda decided not to invite her back over until she learned some manners.|
Contumely|unpleasant behavior or language |The television network felt the show’s dialogue contained contumely that was inappropriate for its young viewers.|
Conundrum|a difficult problem that seems to have no solution|Trying to solve this conundrum is really making my head hurt.|
Convene|to gather for a reason|As soon as the last closing argument is made, the jury will convene to ponder the verdict.|
Convenient|to make something simpler for ease or relief|“If it is convenient for you,” said the neighbor, “I can meet you halfway so you don’t have to travel as far.”|
Conveniently|in a way that is useful/fits well|Tags are conveniently placed on each item so that shoppers will know how much they cost.|
Convent|a place where nuns live; nunnery|The young nun committed her life to the community the day she took her vows at the convent.|
Convention|a formal meeting or assembly|A convention was called so that the delegates could vote on the laws.|
Conventional|describing the standard or the norm|In many cultures, a handshake is a conventional greeting exchanged between people meeting for the first time.|
Converge|to come together from different places to meet at one point|Every year, my family chooses to converge in Georgia from all around the United States for our family reunion.|
Convergence|two or more things coming together to form a new whole|Because of the convergence of political views in the legislature, it is highly likely the government will be able to vote on the budget proposal without any bickering.|
Conversant|to be familiar with or have inside knowledge about the facts of something|The man is conversant in several different languages including French and English.|
Conversation|The exchange thoughts through spoken word (talking)|During their conversation about summer vacation, Thomas and his dad came up with some ideas of fun things to do.|
Conversational|speech or writing that is relaxed or casual|The blog article had a conversational tone that made it easy to read and understand.|
Converse|to engage in conversation|I chose to converse with my younger sibling in the grocery store while we waited for our Mom to finish talking with her friend.|
Conversely|on the other side or hand|The trip wasn’t all good, and conversely, it wasn’t all bad.|
Convert|to change in form|At the airport, kiosks are set up to convert Chinese yen to American dollar bills.|
Convex|shaped like a ball; having a distinct curve that leads into or forms a circle|An ice cream scoop’s convex shape make it great for perfectly round scoops.|
Convey|to deliver or make understood|The popular writer hoped his personal story would convey a message of hope to all those living with depression.|
Conveyance|relocating a person or item usually by means of a large vehicle|Fishermen in Iceland have large boats for the conveyance of haddock to local fish markets.|
Convict|to find someone guilty of a crime|The jury will probably convict the man of murder since he was found with the victim’s blood on his hands.|
Conviction|a firmly held belief or opinion|He had such a lack of conviction of his suitability for the job that he skipped the interview entirely.|
Convince|to talk someone to into doing or believing something|Even though his drinking was a problem, no one could convince the alcoholic to get help.|
Convivial|friendly and making you feel welcome|Carl was a convivial party host who made everyone feel at home.|
Convocation|a sizable gathering of people |The convocation of Baptist ministers is so large it’s being held in the city’s largest auditorium.|
Convoke|to call together or summon a meeting|The chairman decided to convoke a meeting to discuss the company’s budget issue.|
Convoluted|extremely complex and difficult to follow|My head began to hurt as I listened to the professor’s convoluted speech.|
Convoy|a group of vehicles that move as a unit for safety reasons|As the convoy of missionaries travelled through the dangerous jungle, they were escorted by a team of soldiers.|
Convulse|to shake violently|During the seizure, the man’s muscles tightened, and his body began to convulse back and forth.|
Convulsion|a sudden and uncontrollable movement of the body|The man was wracked with a convulsion when his Parkinson’s kicked in, causing him to shake uncontrollably.|
Coolly|done calmly and in a way that does not show excitement|The soldiers tried to react coolly and calmly even during the chaotic mission.|
Cooperation|the act of working together or the actions taken by an individual to be helpful|It took the cooperation of the entire team to meet the fundraising goal.|
Cooperative|ready to work with another person or in a team|The first team was very responsive and cooperative in updating data.|
Coordinate|each of a group of numbers that can be used to find the location of something|Because one coordinate is wrong, the address won’t help us find it to our location.|
Coordination|a procedure or system of arranging people or things so that they function successfully|Due to my coordination of the project at work with my department, my boss gave me a raise since the project was done in a timely and efficient manner.|
Cop-out|an instance of avoiding commitment or responsibility, generally with an excuse|Even though taking out the trash is supposed to be my little brother’s job, he managed to cop-out of it by pretending that the dog needed to be walked.|
Cope|how well or effectively a person can deal with a difficult or tragic situation|The farmers were unable to cope with the harsh dry weather and many of their crops died.|
Copious|large in number or quantity|To avoid having a hangover, do not drink a copious amount of alcohol.|
Copra|dried coconut kernels or meat that produces coconut oil|Because coconut oil is found inside the copra, the meat of the coconut isn’t discarded after use.|
Copse|a group of small trees or shrubs|Six oak trees made up a little copse to the right of the farmer’s house.|
Copy|the result of copying; an identical duplicate of an original |My doctor was able to give me a copy of my test results.|
Copycat|one who copies the ideas or behavior of someone else|He called me a copycat for wearing the same shirt as him.|
Copyright|exclusive legal ownership that is given to someone for something they create|If you write a book, you will have it under copyright, and no one can reproduce it without your permission.|
Coquetry|behavior that is flirty in nature|It was hard for Rick to ignore his wife’s shameless coquetry with other men.|
Coquette|a flirty lady with the male population to seek their appreciation|When the young man saw the coquette playfully teasing other men at the party, he was heartbroken.|
Coquettish|playful in a flirtatious manner|My sister is a coquettish woman who enjoys flirting with men.|
Cord|unit of measurement for firewood |Dominick entered the kitchen with a heavy cord of wood, his thick arms bulging under the load.|
Cordial|warm and sincere|The bellman’s cordial greeting made me instantly fall in love with the hotel.|
Cordillera|a series of mountain ranges that run parallel and serve as the main mountain range of a continent|In North America, the Rocky Mountains and the Sierra Nevada range make up a cordillera that stretches through the west.|
Cordon|to create a barrier around or from something|Since children could get injured on playgrounds, it is essential to cordon off a playground so they don’t have access to it through the fence.|
Corduroy|heavy fabric with vertical ribs|I like rubbing my fingers across the ribs of my corduroy pants.|
Core|a center and usually main part of something compared to its surroundings|Once the teacher was able to get to the core of the problem, the other information regarding the problem was really irrelevant.|
Cornerstone|a key part of something|Keith’s belief in Christ is the cornerstone of all his successful relationships.|
Cornucopia|a large amount of something|The gigantic farmer’s market has a cornucopia of fresh foods.|
Corollary|a natural consequence, or a result that naturally follows|While the expected corollary of staying up all night was to ace the final exam, Cynthia found that she actually fell asleep halfway through and didn’t finish.|
Coroner|an official who investigates violent, sudden, or suspicious deaths|The coroner examined the body for foul play.|
Corporation|a large business that under the law has the rights and duties of an individual|Corporation tax cuts meant that the business could save money on levies and put it back into the company.|
Corporeal|tangible; of a physical nature|As Jack reached for the ghost, he realized it was not corporeal when his hands went straight through the shape.|
Corps|a band of people operating together|As the corps of volunteers worked on the house, they were able to provide a poor family with the opportunity to own their own home.|
Corpse|a dead body|Police found the corpse of the missing woman outside of her friend’s apartment building.|
Corpulent|having a large bulky body|After overeating for months, the skinny girl became somewhat corpulent.|
Corpus|a large collection of writing|The corpus contained many different articles written by the author shortly before his death.|
Corral|a small fenced-in area for animals, usually farm animals|Trainers will typically take their horses inside the corral so that they can teach them certain talents without worrying about the horses escaping.|
Correct|free from error; true; the state of having an affirmed truth |You are correct that a sedentary lifestyle is generally bad for your health.|
Correlate|having a shared connection in which one factor influences another |Studies show intelligence is unique to each person and does not correlate to a specific race or gender.|
Correlative|mutually related|The child's right to education is a correlative of the parent's duty to send the child to school.|
Correspondence|messages exchanged between people|In times of war, my mother often sends correspondence to active duty servicemen.|
Correspondent|a person; journalist who communicates information to a newspaper, radio or television |A correspondent for Reuters news agency says he saw a number of demonstrators being beaten.|
Corridor|a hallway that leads into rooms or other divided areas|Looking for our mother’s room, we walked down the hospital corridor.|
Corroborate|to strengthen or support with other evidence; make more certain|I prayed my friend would corroborate the lie I told my parents!|
Corrugated|containing a wavy exterior; wrinkled|The roof was made of corrugated material so the rain could flow down easily.|
Corrupt|to degrade or demolish someone’s or something’s truthfulness and reliability|Illegal drug use would corrupt the athlete’s career causing people to have no faith in the young man.|
Corruptible|having the ability to be degraded and defamed|One of the police officers realized that he worked among a corruptible group of police officers when they started talking about stealing the drug money they had seized.|
Corruption|the act of corrupt; loss of purity or integrity by authority figures|The corruption within our government branches corrodes public confidence.|
Corsage|a small bouquet of flowers worn on a woman's dress or worn around her wrist to a formal occasion, traditionally purchased by the woman's date|Placing the corsage on her wrist, he thought to himself that the flower’s color matched her dress perfectly.|
Cortege|an individual’s entourage or a grave procession|A cortege of vehicles followed the hearse into the cemetery.|
Coruscate|to give off flashes of light|The diamonds began to coruscate in the bright light.|
Cosmetic|external or superficial; pertaining only to the surface or appearance of something|Fortunately, the damage to the house was mostly cosmetic and a bit of paint covered it nicely.|
Cosmic|incredibly important or large|The cosmic medical discovery is going to save millions of lives.|
Cosmopolitan|reflecting the influence of numerous cultures and countries|Since Jane loved being around people of various cultures, she enjoyed the cosmopolitan atmosphere of the international market.|
Cosmos|the world viewed as a serene and organized place|In observance of the cosmos of life, everything that is born must also die.|
Cosset|to treat like a pet; to overly indulge|From buying expensive toys to boxing vegetable-free lunches, the mother would cosset to her child's every whim.|
Coterminous|having the same border or covering the same area as something else|The little town of Richland is coterminous with the parish of Richland as they share the same border.|
Cottage|a small, simple house usually located in the forest or countryside|The quaint little cottage was the perfect place for a weekend getaway.|
Cougar|an older woman who prefers to date much younger men|Cougar dating sites hook older women up with much younger men.|
Cough|to sharply dispel air from the lungs, usually when something is lodged in the throat or irritating it|The child choked for a moment on his hot dog, but after a cough or two he managed to dislodge the piece of meat that endangered him.|
Council|a board or assembly that meets to advise or discuss things|Head of the school board council, Mr. Meador was responsible for running the meetings once a month.|
Counsel|a lawyer or attorney|The man decided to find new legal counsel since his current attorney doesn’t seem to care about his case.|
Counselor|a person trained to give guidance on problems|Visiting the counselor, the woman hoped that his guidance would help her with her personal problems.|
Countenance|a person's face or facial expression|Even though Janet is a very young woman, her rough countenance makes her appear much older.|
Counter|to retaliate or react to a typically hostile action|The politician had to counter the accusations being made against him, but he did not have a suitable defense to do so.|
Counteract|act against or in opposition to something|To counteract the violence in the community, the police increased the number of footmen on patrol.|
Counterbalance|to oppose or balance something with another thing of equal weight or force|A pulley system was used by the movers to counterbalance the weight of the furniture during delivery.|
Counterclaim|a claim or suit filed in response to a claim made against a group or individual|Filing a counterclaim will allow us to replace the funds we spent defending ourselves in this silly lawsuit.|
Counterexample|an example that contradicts a theory or opinion|The math teacher provided a counterexample to prove to the student that her solution was incorrect.|
Counterfeit|a fake version of an original item|The man was arrested for making counterfeit money.|
Counterintuitive|the opposite of what makes sense|While this idea may sound counterintuitive to what you are trying to do, it really can help increase your sales.|
Countermand|to change or retract a command|Since the bank robbers have hostages, the police chief decided to countermand the order to storm the building.|
Counterproductive|resulting in the opposite of the looked-for effect|The measures are counterproductive and have only increased crime in our community.|
Countervail|to counter something with equal force to offset its effect|To countervail the customers’ concerns about poor service, the company sent out a letter offering to make things right.|
Countless|too many to be counted|Countless stars lit up the night sky.|
Couple|two partners in a romantic relationship|Congratulations are extended to the newly married couple and their families.|
Coupled|together with; combine|Being depressed coupled with a poor diet can lead to mental and physical exhaustion.|
Couplet|a pair of lines with rhyming end words|Many primary grade pupils enjoy rhyme in a couplet when writing poetry.|
Courage|the quality of a confident character not to be afraid or intimidated easily|No longer wanting to suffer, the boy gained the courage to stand up to the bully.|
Courageous|possessing the ability to overcome fear to enter into a dangerous activity|The courageous firefighters rushed into the burning building to save the trapped women and children.|
Course|a path that something or someone moves along |Outside the golf club members were working hard to prepare the course for open week.|
Court-martial|a court where cases of military law is heard|That case concerned an officer's conviction by a court martial in India of an offence of grossly insubordinate conduct.|
Court|the session of a judicial assembly for civil and criminal cases |Because of protests for a man on trial, the security measures in the court building was tightened.|
Courteous|displaying respect for other people|The courteous young man held the door open for the elderly woman.|
Courtesan|a prostitute to men of great wealth or power|As the king’s mistress, the courtesan was one of the highest paid prostitutes in all of Europe.|
Courtier|a companion of a queen, king, or another ruler at a royal court|The courtier followed the queen around the castle, attending to her every need.|
Courtliness|having the mannerisms or attributes befitting someone of high breeding; elegance, good taste, and/or manners|The courtliness of the ballroom could be found in the elegant chandeliers, expensive curtains, and gold fixtures.|
Couth|well-mannered and sophisticated|The couth young man handled himself well at the formal dinner.|
Couture|the production of high-end custom made clothing|The best time for designers to show their couture is on the red carpet at the Emmy awards worn by the actors.|
Coven|a secret gathering of individuals, especially witches|A coven of witches met at midnight so they could discuss which spells and potions they would use on their neighbors.|
Covenant|a binding arrangement; a contract|The priest’s covenant is an agreement between him and God.|
Cover|to place something over or upon, as to conceal or protect|Remember to cover the pot with a lid while you are cooking pasta.|
Coverage|the handling or reporting of an issue by the media|Because there wasn’t much news coverage of the issue, protestors began to riot in the streets.|
Covert|hidden or secret|The spy went to great lengths to make sure his enemies would not discover his covert plans.|
Covetous|displaying greed for another individual’s belongings|The covetous woman couldn’t stop staring at my designer handbag.|
Covey|a small flock of birds|The hunter attempted to scare a covey of birds out of the brush they were nesting in, but the loud air horn he used served only to deafen his own ears.|
Coward|an individual who fears doing unpleasant or risky things|Jim is a coward who stood silently as five boys attacked his little brother.|
Cower|to crouch as in fear or shame|When he was afraid, the little puppy would crouch down and cower in fear.|
Cowl|a long hooded cloak, usually worn by a monk|Placing the hood of his cowl over his head, the monk made his way into the temple.|
Cowlick|an unruly section of hair that stands up or grows in different direction from rest of the hair|Thomas finished applying the gel to his hair, although he couldn't get rid of that annoying cowlick in the back of his head.|
Coxcomb|an arrogant man who is more concerned about his clothes than anything else|As the middle-aged coxcomb strolled down the sidewalk in his clean suit, he stopped into the window to observe his appearance.|
Coyly|in a reluctant manner|Because Ellen stared at me coyly, I knew there was more information she wasn’t telling me.|
Cozy|warm and comfortable|Sprawled out in front of the cozy fire, the relaxed cowboy could barely keep his eyes open.|
Crabby|grumpy and irritable|Usually after paying the bills, it is recommended that children stay away from their parents because they may be crabby from losing so much of their monthly paycheck.|
Crack|the partial exterior break of something without complete separation|While washing the car, Sara noticed a small crack in her windshield and had it repaired immediately.|
Crackdown|immediate stern measures; increased enforcement |Police are hailing raids as part of a national crackdown on illegal drugs a success.|
Crackle|a fizzing popping sound exhibiting similar patterns|Adam sat bold upright in his tent as the crackle of twigs breaking caught his attention.|
Cradle|a rocking infant’s bed that usually has sides|After singing a lullaby while swinging the baby in his cradle, Baby Bobby quickly fell asleep.|
Craft|an activity such as weaving or making pottery that requires you to make things with your hands|The retired teacher is looking for a new craft to take up since she is good at making things with her hands.|
Crafty|cunning and tricky|The crafty wolf was able to trick Little Red Riding Hood into thinking he was Grandmother.|
Craggy|used to describe landscape that is rough and uneven|The craggy peaks of the mountains are so uneven that no hiker could ever stand on them.|
Cram|to stuff; completely fill|Trying to cram six chapters of information the night before the test resulted in a failing grade.|
Cramp|a small convulsion caused by a muscle that hurts|After swimming in the hot sun right after eating a large lunch, a cramp formed in my stomach making me double over in pain.|
