Message|usually a brief form of communication sent to someone in form of written or spoken|If I can’t answer my phone when you call, please leave me a message and I will call you back.|
Messenger|a person who delivers someone a message, packages or documents|The law firm sent a messenger to pick up the documents from their clients business office.|
Messiah|one who is thought to be the savior of a certain group|Many of the politician’s followers see him as a messiah who will fix all of their problems.|
Meta|a prefix added to a word to explain that one thing is related to other things|The meta-search sites found on the internet all link to the same information.|
Metabolism|the chemical reactions which cause fat cells and/or calories to burn |Jan can eat anything without gaining weight because of her fast metabolism.|
Metabolize|to break down food in the body so it can be used for energy|His body didn’t metabolize iron normally, so he took an iron supplement daily.|
Metamorphosis|an observable change|When Chet started exercising on a regular basis, he experienced a huge physical metamorphosis.|
Metaphor|the use of a word or phrase something that it is not, invoking a direct similarity between them and the thing described|He uses the metaphor of fire to represent hatred.|
Metaphysical|associated with what is believed to be present yet not visible|In the book, the main character spoke to a metaphysical being he couldn’t see.|
Metastasize|to spread or grow to other sites|The idea of revolution began to metastasize and spread like wildfire from Moscow to the impoverished Russian countryside.|
Mete|to give out or distribute|After being caught stealing, the boy waited for his father to mete out his punishment.|
Meteor|a piece of debris from space that enters Earth’s atmosphere and becomes luminescent due to friction, appearing as a streak of light|The satellite from outer space become a meteor as it fell into the atmosphere, coming alight with flame.|
Meter|the basic unit of length in the metric system|A metric ruler was used to measure the shelf to the nearest meter.|
Method|a procedure or technique used to accomplish as task|My simple method to cake baking is different from most pastry baker’s techniques.|
Methodical|in an ordered manner|My husband is very organized and has a methodical approach for doing every task.|
Meticulous|showing great attention to detail; very careful and precise|Because Haley is a meticulous cleaner, every inch of her house is spotless.|
Metonymy|a form of speech in which the title of a thing or person is used to replace a name associated with it |When you refer to the film industry as Hollywood, you’re using a metonymy by calling one subject a name that equates to it.|
Metropolis|a large, heavily populated city|Accustomed to country life, the farmer had a difficult time adjusting to his new home in a metropolis.|
Mettle|strength of spirit; the ability to continue despite difficulties|Of all the young men in the village, Caldor was the only one with enough mettle to face the dragon in its lair.|
Milieu|the environment in which one experiences life|Because my father grew up in a military milieu, he knew he wanted to join the armed forces when he graduated from high school.|
Militant|prone to engage in conflict for a belief or cause|Since the militant group believes the president is a brutal dictator, it is crafting a plan to remove him from office.|
Militarism|an ideology which claims that the military is the foundation of a society's security, and thereby its most important aspect|Because he was a veteran, many of his political ideals followed a form of militarism.|
Military|the armed forces of a country|Without a military, a country cannot wage war with another for lack of soldiers and weapons to wage it with.|
Militate|to influence or have an effect upon |The rain will militate a change of venue for our picnic.|
Militia|a military force of trained and organized civilians who may be called to duty|The militia was assigned to assist the police until the National Guard troops arrived.|
Mill|a manufacturing plant for paper, steel, textiles, etc.|Our local paper mill mostly hire people through a temp agency for short-term contracts.|
Millennium|a period that covers one thousand years|The year 2000 saw the end of another millennium.|
Millipede|bug whose skeleton is on the outside of its body and is known for having many legs|As the millipede crossed the room, the children were mesmerized by all of his little appendages transporting his body across the floor.|
Milquetoast|a fearful or shy individual|As the milquetoast quietly shuffled down the street with his shoulders hunched, his eyes would dart around hoping no one would see him.|
Mime|a performer that uses movements and gestures instead of words to express something or tell a story|The face-painted mime used its hands to pretend that it was stuck in a box while performing for the children.|
Mimic|to imitate|Bert can mimic the barking of a dog to perfection, scaring thieves away from his property.|
Mimicry|the act of mirroring an action or behavior|During the talent show, the boy won the audience over when he performed a mimicry of his favorite rapper.|
Minatory|expressing a threat|The hate group left a minatory threat in the form of a burning cross on the couple’s lawn.|
Mince|finely chopped|When we cook we will mince the onions and peppers so they will enhance the flavor of the meat and not overpower the meats overall taste.|
Mincing|dainty and refined, especially in the way that one walks|The woman spoke to her precious pup in a sweet and mincing voice.|
Mindful|thoughtful, considerate and dutiful|Since the child was burned by a fire, the teacher told the other students to be mindful of their classmate’s feelings by refraining from talking about the blaze.|
Mindless|to be done without explanation or care for the results of the actions|The criminal committed mindless acts of violence where innocent people were hurt.|
Mindset|an established set of attitudes and beliefs that someone holds|A person’s mindset is often determined by how they have been raised and the experiences they have had, though the way they think can change over time.|
Mingle|To mix or combine (people or objects) |The spies decided to mingle in with the crowd and see if they could find the killer.|
Miniature|petite in size compared to a larger representation of the item|A miniature model of the castle was created with modeling clay and made it easy to see what the whole castle looked like.|
Minimal|likely the smallest amount |With minimal supervision, the employee was supposed to work by himself and pose only limited questions to the boss.|
Minimum|the smallest or lowest of something|Since the minimum age requirement to ride the amusement park’s roller coaster was 12, the 11-year old had to wait for her friends on the ground.|
Minion|an individual who obeys the commands of another person|At work, I’m a minion who does everything my boss says.|
Minister|a person who is trained to perform religious worship|The minister at our local church spoke a fresh and interesting sermon to their parishioners on Easter Sunday.|
Minor|a legal term meaning child or one under the age of 18|The clerk at the store got in trouble for selling cigarettes to a sixteen-year-old minor.|
Minority|the smaller percentage of the whole|As they looked around the room full of red-clad Republicans, the Democrats knew they were in the minority and their hopes of stopping the bill were destroyed.|
Minuscule|quite small|Many fast food workers are quitting their jobs because of minuscule salaries.|
Minute|a unit that equals 60 seconds of time|With the last test for the school year approaching, Carol is spending every spare minute studying.|
Minutiae|tiny unimportant details |The students ignored their teacher as she told them minutiae about her boring life.|
Miraculous|astounding in a way that suggests a miracle|Her miraculous recovery surprised the hospital staff.|
Mire|a situation or circumstance from which it is difficult to escape|Getting arrested was a mire of unfortunate circumstances the parolee had tried to avoid.|
Mirrored|having a surface that is reflective like a mirror|The mirrored sunglasses reflect out and stop others from seeing through the lens.|
Mirth|amusement and joy|It was obvious from Jacob’s mirth he found the movie to be quite funny.|
Mirthful|filled with joy|The mirthful boy couldn't stop smiling after opening his holiday gifts.|
Misanthrope|a person who hates or distrusts humankind|The old man was a misanthrope who surrounded his entire yard with barbed wire to keep his neighbors at bay.|
Misapprehension|a failure to understand something|The Police Commissioner is under the misapprehension that he can do what he chooses without following the laws.|
Misbehave|to act disobey or act in a way that is bad|Because the child continued to misbehave, he was placed in the corner for a time out.|
Miscegenation|the mixing or blending of race; interracial marriage|Laws against miscegenation caused one to never see a married couple with a Caucasian husband with an African American wife.|
Miscellaneous|consisting of many different kinds of things that might not go together|As a collector, he would sometimes buy a miscellaneous assortment of pennies hoping to find one worthy money.|
Mischief|playful wrongdoing or troublemaking|The children would always get into mischief if they were left unattended.|
Mischievous|badly behaved; naughty|Garry’s dog is very mischievous so don’t be thrown off by its cute smile.|
Miscible|capable of two fluid substances being completely mixed together|Since the contents in the glass became cloudy, it was apparent to the girl that the miscible solution in her glass had more than one liquid in it.|
Misconceived|to misunderstand|I can’t believe there’s still people who often compare misconceived women to be weak in a leadership role.|
Misconception|a belief that is incorrect|The explorer set out to disprove the misconception about the Earth’s flatness.|
Misconduct|unacceptable or inappropriate behavior|Police misconduct within the sheriff’s department caused several officers to be fired.|
Misconstrued|to interpret something the wrong way|Carla had no idea that her intended compliment had been completely misconstrued by her aunt.|
Miscount|to count something incorrectly|Because there are hundreds of pills in the bottle, it is very easy to miscount the amount inside the container.|
Miscreant|an individual who has misbehaved|The principal took the miscreant out of my classroom and placed him in the in-school suspension room.|
Misdeal|to make a mistake while dealing cards|The casino worker was careful not to misdeal when shelling out cards to the poker player.|
Misdeed|something that should not have been done|Gina will have to serve some jail time for her misdeed.|
Misdemeanor|a minor crime|After driving her vehicle on a suspended license, the woman was slapped by the court with a misdemeanor requiring her to pay a fine and spend the night in jail.|
Misdirection|the action or process of directing someone to the wrong place or wrong instruction|Misdirection of the tourists caused them to be lost downtown for several hours.|
Mise-en-scene|the process of setting up a stage for a play or performance|The crowd seemed oblivious to the mise-en-scene, keeping their eyes on the actors even as the scenery was being changed.|
Miserable|extremely unhappy and depressed|Though she pretended to be happy, the woman was really miserable and hated her life.|
Misery|a state of suffering|Living in a state of misery, the refugees suffered greatly because of their country’s war.|
Misfire|to fail to fire a gun or missile correctly|A glitch in the release system caused the rocket to misfire and it quickly exploded in place.|
Misfit|a person whose personality or behavior sets them apart from others|Because she is such a social misfit, Gina has a hard time finding anyone at school wants to be her friend.|
Misfortune|an unfortunate event|A misfortune caused Bill to miss his own birthday party.|
Misgiving|a feeling of doubt|When I learned my daughter’s boyfriend had just been released from prison, my misgiving about him became stronger.|
Misgovern|to run a country or organization unfairly or inefficiently|Because they are being bribed, it’s not shock that the administration would misgovern the country.|
Mishap|an unpredictable accident, mistake or problem|At the yearly fourth of July fireworks tonight, there was a mishap due to computer software problems that shut down the show early.|
Mislead|to make someone believe something that is untrue by giving them wrong or incomplete information|She would mislead all of her boyfriends into believing she wanted something more serious.|
Misleading|giving the wrong idea or information|Misleading advertisements made it seem the phone was being offered for free when it was not.|
Mismanage|to handle something badly or inappropriately|The over spender tends to mismanage his money and waste it on frivolous things like candy and gambling.|
Mismanagement|handling of something in a way that is wrong or inappropriate|The student’s mismanagement of her time caused her to miss her class and fail her test.|
Mismatch|to combine two things that are not supposed to go together|If you decide to mismatch your socks you will look funny to everyone that sees them, especially if they are different colors.|
Misnomer|a name or description that is incorrect or inappropriate|Since Fred is very skinny, calling him Fat Fred is indeed a misnomer.|
Misogyny|an intense dislike of females|The boy’s misogyny hailed from the abuse he suffered from his mother.|
Misprint|an error in a printed text|There is a misprint in the very first page of this book, as it misspells at least three words on the first page.|
Misrepresent|to represent falsely; to inaccurately portray something|The video has been edited and doctored out of context to misrepresent the event as it actually occurred.|
Misshapen|altered or damaged so that it no longer resembles its original form|The shopper picked up the misshapen apple, noted it’s bruised skin and tossed it back in the basket.|
Missionary|someone sent on a mission to help others and convince people to join a particular religion|The missionary spent hours every day going door to door, handing out religious pamphlets and books.|
Missive|a written note |While sitting in class, Greg asked his classmate to pass a love missive to his dream girl.|
Misspell|to spell a word incorrectly|Before the spelling bee started, the children were told if they misspell a word, the speller would be removed from the competition.|
Misstep|to step badly or incorrectly|One wrong misstep during a dance competition may end your chances of moving on to the finale.|
Mistake|an error or slip-up|The mom made a mistake when she bought cake instead of vanilla.|
Mistaken|wrong or incorrect|Paul thought he saw a ghost in the corner, but his parents assured him that he was mistaken.|
Mistaking|confusing|Mistaking the salt for sugar seemed to ruin my cookies which caused everyone to refuse them.|
Mistreat|ill-treat someone or an animal physically or emotionally|When people mistreat their pets, they should pay a hefty fine with some of the money going to the animal shelter.|
Mistrial|a trial that ends through an error in the proceedings|Bill Cosby’s rape hearing ended in a mistrial since the jurors were deadlocked and couldn’t come to a decision.|
Mistrust|a feeling of doubt or suspicion|After Kurt was severely bitten by a dog, he developed a mistrust of most animals.|
Misuse|to mistreat or abuse|Naughty children may misuse toys that don’t belong to them by breaking them or throwing them across the room.|
Mite|a little or slightly|The man was acting a mite suspicious, enough that the cops stopped him to find out what he was up to.|
Mitigate|make less severe or painful|The doctor gave me a prescription to mitigate the pain.|
Mitochondria|an organelle found inside a cell that produces energy|As the powerhouse of animal cells, mitochondria are responsible for making energy-packed proteins.|
Mitosis|the course in which a cell divides and forms two distinct cells, each having the same amount of chromosomes as the original cell|A worm that has been split apart can often regenerate through a type of cell division known as mitosis.|
Mixture|an item made by blending different substances together|A mixture of vodka and orange juice is referred to as a screwdriver.|
Mnemonic|anything (especially something in verbal form) used to help remember something|Our math professor taught us a simple mnemonic for remembering how to complete the equation.|
Moat|a thin stream of water that completely surrounds right outside a large house or fortress |Since the dragon could not swim, he dared not cross the moat to any window or door of the castle.|
Mob|an unruly, generally violent crowd of people intent on destruction or harm|The police had to bring out riot shields to hold back the unruly mob of people that were trying to push them back.|
Mobile|capable of being moved; portable|A mobile blood bank parked their bus in a busy shopping center to draw shoppers into stopping by to donate blood.|
Mobility|the ability to shift from one place to another|My broken leg limits my mobility.|
Modality|the way in which something is executed|John gets multiple assignments done by working in a productive modality that allows him to combine tasks.|
Mode|the way in which something is done or happens|Every parent’s preferred mode of communication was email because it was much easier to access than taking a telephone call.|
Model|a smaller replica of an object|Based on the World War II stealth bomber, Johnny built a model of the plane using a kit and some art supplies.|
Modeled|displayed clothing by wearing it|The designer’s assistant modeled a gray sheath dress from with a wool overcoat during the winter show.|
Moderate|An average amount|The girl’s mild to moderate asthma did not affect her in the way it does a person with severe breathing problems.|
Moderately|fairly; reasonably|A string of moderately priced homes hit the market at the same time, creating a positive buyer’s market.|
Moderation|the act of restraining oneself from doing something excessively|Eating fatty foods is acceptable as long as you do it in moderation without overdoing it.|
Modern|taking place during the current times|Using modern warfare, the number of casualties in war has decreased through the use of drones and other high tech equipment.|
Modernism|a movement towards modifying traditional beliefs with modern ideas|Residential modernism in the area moved homes away from country looks and towards clean lines.|
Modernity|the quality of being current or contemporary|The modernity of the Titanic caused many to believe that its technological advancement made it unsinkable.|
Modesty|being reserved in behavior or clothing|Because of her modesty, the young woman was uncomfortable wearing a bathing suit in public.|
Modicum|a small portion|When Jane wore the short dress to the funeral, she proved she did not have a modicum of decency.|
Modification|a change or augmentation to the base form of something|Training wheels are a modification we add to normal bicycles so young children can learn to ride them safely.|
Modify|to change or alter|Teachers are allowed to modify certain student’s test to level the academic playing field.|
Modular|to be built as an evenly sectioned component|Since the office was built with modular cubicles, no one’s office was any bigger or better than anyone else’s.|
Modulate|to control or regulate|Several chemicals coming from the brain modulate appetite, controlling when the body feels hungry.|
Module|a scholastic part which focuses on a topic that is part of a larger unit|In order to pass the virtual course, the student had to complete each module pertaining to a different health issue.|
Mogul|a powerful and/or wealthy individual|The music mogul has a ten-billion-dollar recording empire.|
Moiety|half of something or an equal portion of|If the medicine makes you feel drowsy, you should only take a moiety of the dosage before going to work and the other half when you get home.|
Moil|to work hard|As they continued to moil in the field, the slaves became exhausted from the amount of work expected of them.|
Moist|damp; wet|Because it was a moist area, moss grew freely on the rainforest floor.|
Moisten|to dampen something with water|After licking the envelope to moisten it, I sealed it shut and placed it in the mailbox.|
Moisture|a very small amount of liquid that gives off the feeling of wetness|Moisture sensors are able to turn the vapor sensitive system on when it rains.|
Mojo|magical power; voodoo|The witch’s mojo was strong enough to make any man in the village fall head-over-heels for her.|
Molasses|thick, brown syrup that is separated from raw sugar|In some recipes, syrupy molasses can be substituted for sugar since they both have a sweet flavor.|
Mold|a frame used to form something using pressure|Each floral mold was used to create cookies that were in a flowerlike shape.|
Moldering|decaying or rotting slowly; disintegrating|Once valued possessions now sit moldering in an attic, frayed and covered in a thick layer dust.|
Mole|a little, round, dark raised bump permanently on the skin |The family doctor recommended that his patient get the mole on his back checked out with a specialist since it had grown in size.|
Molecule|a group of atoms that are bonded together|When two atoms join together, a small molecule is created.|
Mollify|to soothe in temper or disposition|I am hoping the hot tea and crackers will mollify my husband and help him relax.|
Mollycoddle|to handle someone or something in a shielding or indulging way|Since the elderly woman only lived with her poodle, she would mollycoddle the dog by providing him with expensive dog treats and a bed fit for a king.|
Molt|to peel off the outside coat or level of skin, feathers, or fur|With dead shreds of skin lying around the cage, it was apparent that the lizard did molt his skin.|
Moment|for a short unknown amount of time|“I’ll take you to the pool in a moment,” my mother said to me so we quickly got into our swimsuits.|
Momentarily|for something to happen briefly |I was momentarily caught off guard when someone sneezed during my enlightening speech.|
Momentary|brief; short-lived|A momentary loss of consciousness during a blackout didn’t last long, but was scary enough to stop the man from drinking.|
Momentous|of huge significance|It was a momentous occasion when the development team finished the project on time.|
Momism|excessive attachment to or domination by one’s mother|Momism led the helicopter mother to follow her son everywhere he went.|
Monarchy|a type of government in which an area is controlled by a monarch like a queen or king|In a complete monarchy, the royal who runs the country makes all the major decisions for the nation.|
Monastery|a place where monks live and work together|Each monk at the monastery has committed himself to a life of peaceful solitude.|
Monastic|relating to monks, nuns, or others who live a secluded life|For the new monks who had recently joined the monastery, the monastic lifestyle was quite shocking.|
Mondegreen|a word that results from the mishearing of something said or sung out loud|Singing the incorrect lyrics, the girl belted out a mondegreen into the microphone.|
Monetary|of or relating to money or currency|Our bank keeps fake bank notes with no monetary value for use in case of a bank robbery.|
Monetize|the process of converting something into money|Website builders are looking for new ways to monetize their sites outside of normal advertisements.|
Money|coins or bills used as a way to pay for goods and services or to pay people for working|More money was needed to buy the supplies to build a neighborhood treehouse.|
Mongrel|any animal resulting from the crossing of different breeds or varieties, especially a dog|The hybrid mongrel was a mixture of several types of breeds of dog.|
Monitor|to watch something carefully|A second school employee was placed on the bus to monitor the children while they rode.|
Monitory|giving a warning or reprimand|The monitory note was sent to the school district to reprimand them for their illegal actions.|
Monk|a man who has withdrawn from the world for religious reasons|When dedicating his life to the Lord, the monk took a vow of both poverty and chastity.|
Mono|an infectious disease also known as mononucleosis or granular fever and causes a high fever, sore throat, swollen lymph nodes, and exhaustion|After drinking after her infected sibling, the sister was infected with mono and ran an extremely high fever.|
Monochromatic|dull in color|The bride wanted her wedding color scheme to be monochromatic, with no bright colors to take the attention off of her dress.|
Monochrome|black and white|Representing her mood, the artist painted her monochrome self-portrait with one shade of blue.|
Monocle|an optical lens made for improving vision in a single eye|The cartoon character wears a monocle on a cord around his neck so he can easily increase the vision in his nearsighted eye.|
Monogamy|the condition of having only one spouse or partner|When my husband and I got married, we took a vow of monogamy.|
Monogram|a design that has at least two interlaced letters, usually a person’s initials|Placing the monogram on her binder, the student loved the way the glittering letters made the plain folder stand out.|
Monograph|a specialist work of writing on a single subject|The acclaimed psychologist wrote his most famous monograph on the art of manipulation.|
Monolingual|to know and communicate solely with one language|Living in a monolingual country, Sarah was limited with collaborating with people from other countries since she only spoke English.|
Monolithic|large in size and challenging to alter | Unfortunately there was no way to make the monolithic project smaller.|
Monologue|a drawn-out speech by a single person that controls a conversation |Before Ellen greets guests on her show, she always welcomes the audience with a humorous monologue.|
Monomania|a mental illness characterized by excessive obsessive or concentration on a single thing or idea|Suffering from monomania, the woman was convinced that the Mexican pop star was in love with her even though they had never met.|
Monomer|becomes a polymer when two similar molecules are joined|In order to study your DNA, each monomer had to come together to form a nucleotide in the double helix structure of your DNA.|
Monopoly|the state in which one entity or individual dominates an entire industry or market|In the game of Monopoly, players strive to own all the properties of a specific color in order to increase their rental fees.|
Monosaccharide|sugar that is in its simplest form|If I wanted something sweet, Weight Watchers recommended eating monosaccharide which is found in fruits.|
Monosyllabic|short responses, consisting of only one syllable|Ancient Chinese words were monosyllabic and easily pronounced since they were so short.|
Monotheism|the conviction there is only one deity or god|In my church we believe in monotheism, the idea of a solitary god.|
Monotone|a tone of voice that does not change|The robot speaks in a monotone expression that never alters in pitch.|
Monotonous|dull, tedious, and repetitious; lacking in variety and interest|Because Marvin was angry at his wife, he gave only monotonous responses to her questions.|
Monotony|repetition or lack of change that makes something boring|Adding seasoning to the bland stew helped break up the monotony of the dish.|
Monsoon|a strong wind in the southern portion of Asia and the Indian Ocean that carries a large amount of rain during the summer months|The monsoon has flooded the small town and kept people indoors for most of the summer.|
Monster|a made-up huge, dreadful animal or beast|When Mary Shelley created her tall, scary monster, it became known as Frankenstein.|
Monstrosity|a thing that is huge and extremely unattractive|The new hotel is a monstrosity that blocks my view of the beach.|
Monstrous|huge; enormous|The monstrous elephant trampled through the jungle crushing everything in its path.|
Montane|residing or belonging to an area with rugged and rolling slopes and a forest-like region|With a montane vegetation, the people living in the rural area knew that they could only produce certain types of crops on such an incline.|
Monument|a large structure or sculpture that symbolizes a notable person or event|Touring the monument allowed the students to get a true experience of what happened at that battle.|
Monumental|important; significant|A monumental and historic decision was made by the Supreme Court regarding marriage rights.|
Mood|disposition; temperament|The worker was so exhausted and irritable that literally anything could cause her mood to plummet.|
Moody|glum or temperamental feelings|Since the toddler didn’t take a nap today, she was moody for the rest of the evening.|
Moon|the lunar body that rotates around planets |Studying the craters on the moon allowed the scientists to get a better idea of how much water could be found on the moon.|
Moonlight|the beam from the moon |The only light shining on the street was the moonlight since all the streetlights had been broken.|
Moonstruck|confused and unable to think/act normally after falling in love|The moonstruck adolescent will do anything he can to keep his teenage love burning strong.|
Moor|to tie up a ship|There are thousands of yachts that moor at the marina.|
Moored|to secure a boat to a dock or to an anchor by a cord, cable or chain|Fisherman will usually double check to make sure their boat is moored in their marina so it won’t drift away.|
Moose|a big animal belonging to the deer family that has hanging fur from his neck plus large antlers |To show off their kill, the hunter mounted the head of the moose on his wall.|
Moot|having no real point|Federal legislation will override the states’ concerns and make them moot.|
Mope|to carry oneself in a depressed, spiritless manner|With her lip poked out, the young girl continued to mope around the house.|
Moral|a lesson|Parents tell their children the story of The Boy Who Cried Wolf because the moral teaches them not to lie.|
Morale|the enthusiasm a person or group has about their duties|Since the soldiers have not seen their families in a long time, their morale is at an all-time low.|
Moralistic|quick to judge others based on a narrow view of what is right and wrong|The moralistic pastor called out members of his congregation for what he saw as sinful behaviors.|
Moralize|to express opinions about whether specific actions are good or bad|Aesop wrote fables to moralize, helping parents teach their children right from wrong.|
Morass|a complicated or confusing situation|Even the smartest lawyer will find it difficult to find a solution for this legal morass.|
Moratorium|the pausing of an ongoing activity |An avid fisherman, Billy was upset when he learned of the fishing moratorium.|
Morbid|associated with subjects that are unpleasant, like death|The boy’s morbid fascination with death led him to collect dead animals.|
Morbidity|the quality of being unhealthful|Even the hardened criminal squirmed at the morbidity of the crime scene photographs.|
Mordacious|having an abrasive attitude or using abrasive words|After the young man cut line at the grocery store, the woman had some mordacious words which embarrassed the man.|
Mordant|having a scathing wit|The mordant mother often used harsh words that made her son cry.|
Moreover|further|For many small companies, moreover, the ability to purchase cash is limited.|
Mores|customs and traditions of community|Social mores of the area insisted that men and women who are courting not spend time alone before marriage.|
Morgue|a building or room where dead bodies are kept before their proper burial or cremation|After the fatal accident, the deceased victim was removed from the vehicle and taken to the morgue until the autopsy took place.|
Moribund|being in the state of dying|Because the wounded man has lost a great deal of blood, he is moribund and probably will not make it through the night.|
Morning|the period of time between midnight and noon|Each day, I rise with the sun and start my early morning workout routine.|
Moronic|foolish or stupid|The man’s moronic statements made no sense to anyone listening to his rant.|
Morose|feeling sad, in a bad mood, and not wanting to talk to anyone|When her dog died, the little girl was morose for months.|
Morosely|in an unhappy manner|The dog stared morosely at the front door while waiting for its owner to return.|
Morphology|the biological study of the size, shape, and structure of animals and plants|Due to its morphology and body makeup, only reproductive ants have wings.|
Morsel|a small piece of food|Devouring the last morsel of cake, the woman realized that sticking to her diet would be harder than she had anticipated.|
Mortality|being subject to death|Questioning his own mortality, the elderly man thought back over the many events of his life.|
Mortar|a strong bowl used to press or grind a substance into a powder|After the pharmacist used the mortar and pestle to crush the pills, he took the medicine and stirred it into the liquid.|
Mortgage|a loan given from a financial institution for a person’s property which causes the person to pay it back plus interest|The newly married couple checked the rates on the mortgage to determine how much they would have to pay for their dream home.|
Mortician|the person who is in charge of a funeral including preparing the deceased body |Often viewed as a scary job, the mortician actually performs a service that is needed by the community.|
Mortification|extreme embarrassment and shame|Although Michael never laid a hand on her physically, she had to endure emotional abuse and mortification because of the way he talked to her in front of other people.|
Mortify|to put someone in the position of being embarrassed|If my mother picks me up from school in her pajamas, she will mortify me in front of my friends.|
Mortuary|a funeral home or morgue|Embalming several hundred bodies at the mortuary, the funeral worker was an experience funeral director.|
Mosaic|a hard embellishment that is created by pushing tiny segments of dyed glass or stone into a pliable substance|The little girl was fascinated by the colorful mosaic that comprised the church’s window.|
Mosquito|a disease-carrying, flying insect that is found in warm environments and sucks the blood of those it bites|The mosquito buzzed around the room, irritating those trying to enjoy an afternoon siesta.|
Moss|a small, flowerless green plant that reproduces through spores in wet places|Scientists have proven that algae adapted to life on earth, growing into other plants including green moss.|
Most|greatest in amount, degree or number; superlative of much or many|After Dan retired from the Army, we decided to move back to our home state where most of our friends and family live.|
Mote|a tiny piece of something|A small mote of glass entered my foot, so tiny that I wasn’t able to pull it out without tweezers.|
Mother|the female biological parent of a child|Every mother wants their daughter to grow up to be just like them in every aspect.|
Motherhood|the state of being a mother to a child|Motherhood proved difficult for the young woman who had little experience with babies before the birth of her son.|
Motif|a reappearing theme in a creative person’s work or style|Death is the depressing motif that appears in each of the artist’s paintings.|
Motility|the ability to move around in fluid|Personal lubricants can interfere with sperm motility and hinder sperm from being able to make it to the egg.|
Motion|the process of moving|Putting the ball into motion, the pitcher prayed that the batter would not make contact.|
Motionless|to be still or stopped|Once I noticed the motionless man sitting on the park bench, I thought he was asleep.|
Motivation|the drive someone has for conducting himself or herself in a certain way|Usually the only motivation for teenagers going to school is to socialize with their friends.|
Motive|a reason; motivation|Although he had no motive to commit the crime, police were sure that the suspect was innocent.|
Motive|reason; purpose|With several clogged arteries, the unhealthy man had a serious motive to lose weight and get fit.|
Motley|made up of strikingly different components|The motley group of job applicants included a retired teacher, a recently released convict, and a sixteen-year-old girl.|
Motor|a piece of equipment that is powered by ignition or a form of electricity in order to operate a machine |Mechanics know exactly how to take apart a motor and put it back together in a matter of minutes.|
Motto|a motto is a phrase about values and beliefs|The personal trainer’s motto is, “No pain, no gain, remain the same”.|
Moue|a pouty expression made with the lips to show annoyance or disapproval|Giving a lip-quivering moue, the spoiled girl was able to get her way with her parents.|
Mould|a hollow container that gives shape to a liquid poured into it once it has cooled or is frozen|I forgot to spray the mould with oil, causing the waffle batter to stick to the frame while cooking.|
Mound|an elevated heap or pile|Rolling down the steep mound, the children laughed as they turned over on the dirt.|
Mount|to climb or get on something|Trying to mount the horse, the nervous rider fell of several times before actually getting on.|
Mountain|an area of elevated land that rises very high above the land around it|As an experience mountain climber, the explorer knew the importance of pacing yourself on a long trek up.|
Mountainous|filled with many mountains|The mountainous area is so hilly, its tall peaks making it virtually uninhabitable.|
Mountebank|an individual who tricks others|The mountebank made his living by conning elderly widows out of their life savings.|
Mourn|to grieve and be extremely saddened by a loss|It has been years since her mother’s death, but Debra continues to mourn her loss.|
Mournful|filled with grief or sadness|The mournful sounds emerging from the funeral parlor made me very sad indeed.|
Mourning|mourning means a time to show deep sorrow|At the funeral, the crowd was mourning and celebrating the loss and life of a loved one.|
Mouse|a mouse is a small rodent|I wasn’t sure if I saw the cat eat a rat or a mouse.|
Mouth|a mouth is the opening at the lower part of the face|Your hands could be contaminated so please don’t touch your mouth until you wash them.|
Mouthful|a long or complex amount of words that is difficult to say|My friend challenged me to say a tongue twister three times fast, but it was such a mouthful that I couldn’t manage it.|
Move|move means relocate|Instead of standing still in line, the children chose to dance and move the entire time.|
Movement|the process of changing places or positions|Sudden movement in the back of the house sent the dogs barking and startled their sleeping owner.|
Movement|the act of changing one’s location through motion|The science teacher taught the students that the back and forth movement of the water was called tides.|
Movie|a recording of movie images that tells a story|The movie theater plays several new films a week while retiring older ones.|
Mown|having had the grass cut down in a yard or field|My neighbor’s tall grass has not been mown in over three months!|
Moxie|the ability to face challenges with a courageous and determined attitude|The mountain climber proved his moxie by refusing to give up when faced with another dangerous peak.|
Much|a great amount|Much of the island is completely covered by forests, with only a few areas being developed.|
Muck|muck is dirt or waste|Our old truck was filthy since it was covered with gravel, muck, and dirt.|
Muckraker|a person who spreads damaging rumors about another individual, generally for political gain|Although the journalist likes to think of himself as a do-gooder, he is actually a muckraker who writes false stories about politicians.|
Mudslinging|the use of insults and accusations as a way of tarnishing someone’s reputation|Because of their constant mudslinging, both political candidates were known as slanderers.|
Muffle|to deaden sound by covering or wrapping|Example sentences for Fiduciary. Read this page and learn how to use Fiduciary in a sentence.|
Mug|a mug is a large round cup|On a cold winter day, I sipped the mug of hot chocolate as I watched my favorite movie.|
Mugwump|a term for 1884 Republicans who voted for the Democratic candidate (Grover Cleveland) over their own party candidate who they viewed as corrup|Independent and liberal, the mugwump refused to vote Republican in the 1884 election and submitted his ballot for Cleveland instead.|
Mulatto|an individual of black and white descent|The mulatto girl has a black mother and a white father.|
Mulct|the extort money from someone|The unethical reporter managed to mulct $500,000 from the corrupt police department.|
Mule|a carrier of things for someone else|As a mule for the drug cartel, the shady man was paid to carry narcotics into the United States.|
Muliebrity|womanly qualities; femininity |The sexy songstress’s muliebrity set her apart from the less feminine women in the club.|
Mull|to think about something deeply and for a long period of time|As she continued to mull over the long list of potential performers, the entertainment director wondered if she should just feature someone internally.|
Multicellular|being complex with many different cells|The transition to multicellular life from single celled organisms has been of interest to scientists for many years.|
Multicultural|diverse|The multicultural fair had booths from many different countries, each displaying ethnic food and wares.|
Multifarious|having great variety; numerous|Coming from a small town of only four hundred residents, Jonas was shocked by the millions of people who made up the multifarious population of the big city.|
Multifold|numerous; varied|Interest in the robotics competition was multifold, with many different groups applying for entry.|
Multilateral|including many sides or parties|The multilateral lender was developed by several different countries and provides financing for national development.|
Multilingual|using several different languages|Many West Africans are multilingual, speaking their tribe language, English, as well as Pidgin English.|
Multimedia|technology that uses a variety of different types of media (sound, audio, video, etc.) to express ideas|The multimedia presentation showed the audience images of what the Titanic looked like while playing clips of actual interviews.|
Multinational|multinational means relating to multiple nations|Britain and the United Stated states are a powerful multinational military force against terrorism.|
Multiple|many; numerous|Multiple survivor accounts were recorded after the Titanic sinking of 1912.|
Multiplicity|a large number or variety|The cruise ship had a multiplicity of staterooms, with at least 200 on each floor.|
Multiply|to increase|After water was added to the gremlins, the amount of creatures in the house continued to multiply.|
Multipurpose|serving several different functions|The multipurpose room served as both an emergency shelter and a meeting room for volunteer events.|
Multitask|to handle multiple tasks at once|Sure, I can multitask. I can eat breakfast and think about lunch at the same time.|
Multitude|a large number of persons|A multitude of people lined up to watch their favorite celebrities walk into the movie premiere.|
Multitudinous|a huge amount|Because Teresa is a very attractive woman, she receives multitudinous messages through the dating website.|
Multiverse|a hypothetical space or realm consisting of more than one universe|Steven Hawking insisted that we live in a multiverse of many different worlds.|
Mum|mute; silent|Staying mum for the time being, the man thought it best he not discuss his plans with anyone else.|
Mumble|to mutter something in a low tone so that it cannot be understood|My little brother will mumble his grievances under his breath but never tell me when I make him angry.|
Mumblecore|a genre of low-budget narrative film that focuses on the intimate lives of young adult characters using dialogue and on professional actors|The mumblecore filmmakers create low-budget films focus on the lives of young lovers.|
Mummification|the process of embalming and wrapping a dead body|Ancient Egyptians used mummification as a way to preserve the bodies of their ancestors.|
Mumps|a contagious viral disease that causes the glands in the face to swell|Because the child’s cheeks were swollen like a chipmunk, the doctor knew that she probably had a viral case of the mumps.|
Mumpsimus|a person who clings to a tradition or custom that is practiced even though it has been prove to be irrational|The mumpsimus continued to mispronounce the word ‘library’ even when he was corrected several times.|
Munch|to chew or crunch on food|Even when I’m not starving, I find myself wanting to munch on candy and other sweets.|
Mundane|Boring, dull, and uninteresting|The restaurant should spice up their menu and replace the dull and mundane dishes.|
Munge|an IT slang term meaning to convert data from one form to another|When the tech starts to munge data, he transforms and maps data from one raw data form into another format.|
Municipal|related to a town or governing body|Municipal elections are held at the city court house once every four years.|
Municipality|a town that has its own local lawmaking body|Citizens knew that living in the municipality meant they would need to vote within this jurisdiction since they acted as their own city.|
Munificent|very generous|The wealthy actor always gives the members of his staff munificent appreciation gifts.|
Munitions|weapons and ammunition used in a war|Hiding a large stash of munitions within the tank, the army proceeded up the hill.|
Murder|murder means to kill|The murder happened on 75th street, and they had to move the body to investigate it.|
Murky|dark and gloomy|The frightened little boy refused to walk with his friends through the murky forest.|
Murmured|whispered|I could not hear the words; she just murmured a lot.‎|
Muscle|muscle is a fibrous tissue that causes movement|Each muscle in the human body serves multiple purposes of movement and protection.|
Muscular|having well-developed muscles|Muscular body builders paraded the stage, showing off their brawn to the judges.|
Muse|something or someone that inspires|The model was the artist’s muse for his famous sculpture.|
Museum|a building in which artistic, historical, or scientific objects are stored and exhibited|A new exhibit at the museum displayed hundreds of remains and pictures of extinct plants and animals from around the world.|
Mushy|having a soggy and squashy consistency |After cooking the peas for too long in a crockpot, the mushy vegetable was too soft to be delicious.|
Music|a form of art that combines vocal or instrumental sounds to create a composition|Guests at the house party grooved to music booming out of the stereo system.|
Musical|melodic or tuneful|The young woman’s musical ability shined through in her singing performance.|
Musicality|musical talent|The Broadway play earned high marks for musicality since many of the songs were top hits.|
Musically|relating to music|Being musically inclined, the dwarves liked to whistle a tune while they worked in the mines.|
Musician|someone who plays a musical instrument|Each musician took the stage and began to play the instruments in unison.|
Musing|a thought or reflection|As I started to jot down a musing on my notepad, my thoughts were cut short by the ringing of the telephone.|
Musk|a substance with a strong, sweet smell that is used to make perfume and other products|Many people who wear the sweet-smelling body spray don’t realize that the musk scent comes from the anal gland of a deer.|
Musket|a heavy, muzzle-loading firearm that was used in the past wars|After loading his musket, the Civil War soldier hid in the woods and waited for the signal to fire.|
Muslim|a follower of the religion of Islam|The Muslim was a follower of Islam, one of the three major monotheistic world religions.|
Mussel|a mussel is an edible clam like animal|The expensive mussel was the top item at the seafood restaurant near the rocky docks.|
Mustache|a mustache is a strip of hair above the upper lip|My sociology professor was drinking a sports drink that put a red stain on his mustache.|
Muster|to gather collectively|Before the cruise ship departs, passengers are required to muster at a specified station for a safety briefing.|
Musty|exhibiting a stale odor|The musty odor of the wet towel made the bathroom smell unpleasant.|
Mutability|the ability to be altered|With the mutability of my work schedule, I’m not sure I’ll be able to attend the concert.|
Mutable|able to be altered |Because our emotions are mutable, they are subject to change often.|
Mutant|mutant means something that had transformed into something other than it was|The radioactive spill caused a small dog to transform into a giant three-headed mutant.|
Mutation|a significant genetic change|A new vaccination had to be created for a mutation of the antigen.|
Muted|muted means to silence something|The muted TV allowed for quiet conversation between the guests.|
Mutely|silently; without speaking|The shy wallflower stood mutely in a corner during the junior high dance.|
Mutilate|to permanently disfigure something, usually by cutting or removing parts|It is hard to believe that parents in some cultures mutilate their daughter’s genitals through religious-based surgeries.|
Mutilation|disfigurement or defacement of a person or object|Mutilation of the slave’s back and face occurred when the plantation owner ordered 40 lashes.|
Mutinous|not following orders; rebelling against authority|Can you believe the bodyguard was the head of the mutinous plot to kill the king?|
Mutiny|an organized revolt against those in power|Dissatisfied voters will mutiny against the current president by voting for whoever runs against him in the next election.|
Mutter|to speak under one's breath, usually in an angry way|As he walked away to do his chores, his mother heard him mutter under his breath.|
Mutton|the meat of a domestic sheep|While a lot of people like chicken, I personally prefer mutton, which we get from the lambs we take care of.|
Mutual|shared; common|The husband and wife came to a mutual agreement that she would drive the new car and he would drive the older one.|
Mutualism|a connection between two plants or animals where each of them profits from the connection|Since the bird would scare off the flies on the horse and the horse would protect the bird, this mutualism lasted for many years between these two animals.|
Mutuality|mutual dependence or reciprocity|The contract depends on the parties’ mutuality and if they can agree on the terms.|
Mutually|felt or done by two or more people in the same group|After years of unhappiness, the couple mutually agreed to a divorce.|
Muzzle|the projecting snout of an animal|The veterinarian wrapped a towel around the dog’s muzzle to stop it from biting.|
Myocardial|relating to the muscular tissue of the heart|Since diabetes can damage the heart, it increases the risk of a myocardial infraction.|
Myopia|a restrictive view or an absence of forethought|My husband’s myopia prevents him from being able to see value in anyone else’s opinion.|
Myopic|particularly biased in one direction|If you only question one race of people in your survey, your responses will be myopic.|
Myriad|of an indefinite large number |Kelly and Clint discuss myriad topics on their talk show.|
Myrmidon|a person who does whatever his leader says|Under the watchful eye of their superior military leader, every myrmidon followed his first request.|
Mysterious|mysterious means difficult to understand|Solving the crime was mysterious because the detectives were missing crucial evidence.|
Mystery|something secret or unexplainable;an unknown|The police are still trying to figure out the mystery of the missing girl who disappeared with her father three months ago and neither one has been found.|
Mystic|spiritualist or shaman|A mystic traveled around the village telling peoples fortunes and offering cures to curses.|
Mysticism|the idea divine truth can be found through profound meditation|The cult leader emphasized mysticism through meditation as the only means of entering heaven.|
Mystified|puzzled or confused|Scientists have been mystified for the longest time about how to prevent cancer from spreading.|
Mystique|the aura of intrigue that surrounds a person or thing|The maiden has a mystique that fascinates men of all ages.|
Myth|a widely held belief that is actually untrue|The myth that holding your laptop in your lap will make you sterile is a product of media sensationalism.|
Mythical|to be similar or like something from a myth|After reading about the mythical creature, the young child was not scared because many events in the story could not have happened.|
Mythology|a group of stories from an area or country’s people and it usually includes gods or goddesses|Students learned about the dangerous creatures while studying Greek mythology in their literature class.|
Mythomane|a person with a strong or irresistible propensity for fantasizing, lying, or exaggerating |The mythomane always thought it was easier to tell a lie than the truth.|
Nabob|a rich and influential person|When the nabob walked into the meeting, everyone stood to show respect to him.|
Nadir|point of greatest adversity or despair; all-time low; rock-bottom|Even though we thought we had reached our nadir and would fail to meet the project deadline, we were still able to complete the work on time.|
Nag|to remind or complain to someone in annoying way over trivial complaints|I have to nag at my children to clean up their rooms daily.|
Naive|having or showing a lack of experience or knowledge|The naive girl believed she could get pregnant by kissing.|
Name-calling|abusive language or insults|The toddlers kept calling each other “stupid,” so their mother put them in time out for their name-calling.|
Namely|especially or particularly|Over the last six decades, several technological innovations have changed how we communicate, namely the Internet and the smartphone.|
Namesake|an individual or thing that is named after another person or thing|My husband shares his father’s name, and as such, he is his namesake.|
Nano|a prefix added to a word to denote that is very small|The nanosensors on the machine are so small they can barely be detected.|
Naphtha|a flammable oil that is used as a solvent and as an ingredient in gasoline|Naphtha is an oily substance that is produced as part of the oil refining process.|
Narcissistic|obsessed with one’s importance and/or physical appearance.|The narcissistic teenager cannot walk more than fifty feet without checking her appearance in her pocket mirror.|
Narrate|to give a spoken or written account of events|The old storyteller in our village is a survivor of a war long past, and he often narrates the events of his final battle.|
Narration|a commentary given with a broadcast of some sort|Many movies have a piece of narration in the beginning to provide the audience with information about the setting.|
Narrative|a tale that is written or spoken|The narrative is a fairytale that tells the story of a poor orphan who becomes a princess.|
Narrow-minded|bigoted and not tolerant of other people’s viewpoints|The narrow-minded cop truly believed only Hispanics commit serious crimes.|
Narrow|a smaller than usual amount of space|The space between the cars was so narrow that she had to hold the door and squeeze through the tiny opening to avoid hitting the other car.|
Nary|not a single one|Unfortunately, nary a restaurant was open at two o’clock in the morning.|
Nascence|the initial start of something that leads to a bigger idea or action|During the nascence of portable computers, laptops that were over twenty pounds were considered lightweight and advanced technology.|
Nascent|recently formed or started|Online dating has gone from a nascent idea to an established concept that helps millions of people find love.|
Nastiness|quality of being gross, dirty, and generally unpleasant|The nastiness of the cheap hotel room was evidenced by the rat droppings, bed bugs, and filthy carpet.|
Nasty|something foul or horrid that can leave one disgusted|The medicine left a nasty taste in the toddler’s mouth, causing her to spit it out.|
Natal|associated with a birth|I consider Smithfield to be my natal home because I was born there thirty years ago.|
Nation|a group of people inhabiting a particular territory and united by common characteristics such as descent, culture, or language|The nation of Germany is unified by the language that the common populace speaks, as well as their history and culture.|
National|related or common to a whole country|The national chain has retail stores in every state in the U.S.A.|
Nationalism|such devotion to a country that other nations pale in comparison |During the war, the rising tide of nationalism resulted in people buying only American-made products.|
Nationality|the position usually citizenship of someone or something being a part of a nation|After realizing that the young woman’s nationality was Israeli since she came from Israel, he was assumed that her ethnicity was Jewish.|
Native|of or relating to the place where you were born|The Latin was not raised in his native country, which is why we believed that he did not possess their mannerisms.|
Nativism|the practice of giving preference to the native residents of an area|Nativism is observed by individuals who believe their culture is superior to other cultures.|
Nativity|birth, specifically the birth of Jesus Christ|During the nativity play, the innkeeper told Jesus’s parents that there was no room for them on the night of his birth.|
Natural|something organic derived from nature that is raw and pure, not having been treated or processed|Natural honey is one of the only raw and pure foods that never goes bad.|
Naturalist|someone who studies life and nature|While wandering in the forest, a naturalist was walking a trail to determine if there were any new birds in the area.|
Naturalization|the process by which a foreign individual is awarded citizenship|In order to become a citizen, Alberto will have to go through the process of naturalization.|
Naturally|to happen on its own, without help|Sarah didn’t have to put hot rollers in her hair in the morning because she had naturally curly hair already.|
Nature|the world of the environment of plants and animals|The refreshing nature hike was just what I needed to become energized and happy.|
Naught|nothing|Everything I wrote was for naught when my computer crashed.|
Naughty|to behave poorly|At Christmas time, Santa will ask children if they have been naughty or nice during the year.|
Nausea|queasiness which sometimes leads to throwing up|Spinning around in circles for thirty minutes made the girl have nausea in her stomach.|
Nauseating|sickening and repulsive|After eating the moldy fruit, the child had a nauseating feeling in her stomach resulting in her throwing up.|
Nauseous|a sick queasy feeling|Due to Kate’s nauseous feeling during the past few mornings, it became obvious that she was pregnant.|
Nautical|relating to or involving ships or shipping or navigation or seamen|We sailed hundreds of nautical miles with no land in sight.|
Navel|bellybutton|Drawing in her navel, the pudgy woman tried to make her stomach look thinner in the mirror.|
Navigable|controllable or maneuverable|Tests were done on the new Boeing plane to determine if it was navigable in the air at high altitudes.|
Navigate|to direct a route|Christopher Columbus would navigate his ship across the Atlantic Ocean to an unknown land.|
Navigation|the procedure that one uses to track a course|Once the plans for the navigation to get to the secret hideaway were in place, the team of detectives quickly drove to find the kidnapped child.|
Navigator|the pilot or director of a vessel in the land, water or air|When the fishing boat capsized, the navigator was blamed for steering the boat into an oncoming storm.|
Navy|a country’s armed service using ships and boats|During the war, the ships from the country’s navy were sent out to defend against the attack on their land.|
Nay|not at all or nope|When Congress decided to vote, the vice president asked the congressman to say yea if they are in favor of the issue or nay if they are not.|
Nazism|the theories and processes of the Nazis|Using the ideologies of Nazism from the 1930s, the Ku Klux Klan now show their racist beliefs through their violent actions.|
Near|the small span between two objects or things |The only reason Ginger moved near the mall was so she could go shopping frequently.|
Nearby|to be close by to something|Since Walmart was nearby, we ran to the store to quickly purchase the costume for the play.|
Nearer|closer or not as far away|The fan tried to draw nearer to the musician, but the star’s security blocked the stage.|
Nearly|approximately or about|Ms. Fisher allowed her son to go play outside since he was nearly finished with his homework.|
Neat|orderly; arranged|Each neat row of corn in the farmer’s field was planted efficiently for a quick harvest.|
Neat|tidy and well-ordered|A neat stack of post it notes sat in a pile on the accountant’s desk.|
Neatly|in a tidy or organized way|Stacking the papers neatly, the assistant attempted to organize the doctor’s cluttered desk.|
Neatness|the act of being tidy and orderly|Alan suffered from Obsessive Compulsive Disorder due to his desire to have extreme neatness in the house at all times.|
Nebbish|one who is nervous and lacks confidence and courage, especially in making decisions and plans, in discussions, debates, arguments, and confrontations, and in taking responsibility|The nebbish refuses to take responsibility for his actions, always too afraid to admit that he made a mistake.|
Nebula|a space cloud consisting of gas or dust|I love to venture out into the open fields on a clear night and gawk at every galaxy and nebula that my naked eyes can detect.|
Nebulous|Unclear, vague; not clearly defined|It was not difficult to realize her answer to the question was nebulous.|
Necessarily|automatically; certainly|Putting down that you are a felon won’t necessarily stop you from getting the job, but it probably won’t help either.|
Necessary|being required or vital|For the chocolate cake, the necessary ingredients included flour, eggs, butter and cocoa.|
Necessitate|to make essential as a result of something|The heavy rain will necessitate the use of an umbrella.|
Necessities|needs or essential supplies|Even though the spoiled wife believed that a sports car and lots of money were the necessities of life, she could have lived with a regular sedan.|
Necessitous|deprived and poverty-stricken|The necessitous circumstances surrounding the flood victims became evidence when we saw all of the destruction.|
Necessity|to be essential or vital|Water is a necessity of life because failure to drink water in three days will cause death.|
Necrology|a biographical description of a person who has recently died|My grandmother’s necrology was posted online so that everyone could see what a wonderful person she was.|
Necromancy|the act of communicating with spirits of deceased individuals|When Maggie’s husband died, she visited a psychic who claimed she could use necromancy to talk to deceased persons.|
Necrosis|the complete deterioration of a bodily organ|Cancer first caused the necrosis of the liver which led to the liver failing to produce proteins used in coagulating the blood.|
Nectar|the sweet liquid produced from certain plants and flowers that bees turn into honey|Instead of acquiring the nectar from the plant, the farmers knew to wait until the bumblebees would convert it into honey.|
Nee|born with this name usually before getting married|Harriet Tubman, nee Araminta Ross, helped slaves escape to the North using the Underground Railroad.|
Needle|a long thin sharp pointy device that holds thread and is used for stitching fabric|When I tore my shirt, my friend grabbed a needle and thread in order to sew the material back together.|
Needless|not essential or wanted|Usually, the child spoke needless words simply because he was used to babbling all day about random things.|
Nefarious|very evil and wicked|How nefarious of you to fling dog crap on my car!|
Negate|to cause something to be ineffective; to nullify|Be careful when shopping because you do not want unnecessary purchases to negate the value of the coupons you are using.|
Negative|a gloomy outlook on something|Teenagers usually have negative attitudes toward adults because they think they know everything.|
Negative|focused on what is bad, harmful, or lacking|Negative effects of the medicine have stopped many patients from taking it.|
Neglect|to abandon or ignore|When you have children and work a full-time job, you may neglect your appearance because it is not important anymore.|
Negligence|neglect; inattention|The parent’s negligence resulted in their children being taken from their care and placed in a safer home.|
Negligent|careless; irresponsible|I felt negligent for leaving Jean’s toddler alone in the car.|
Negligible|too small to be of importance|Since the price difference between the generic item and the brand item is negligible, I will buy the brand product.|
Negotiable|capable of being bargained or bartered with|Even though the house was priced very low, the potential buyers still believe the price was negotiable.|
Negotiate|to try to reach an agreement or come to terms|We sat down to negotiate a deal that would satisfy everyone.|
Neigh|the sound a horse makes|Whenever anyone would get close to the fence, the horse would neigh to get the attention of its master.|
Neighbor|a person who resides nearby|While baking a cake, I needed to ask my neighbor for sugar since I had just run out.|
Neighborhood|an area where people live close together|The single woman became frightened when a prowler was spotted in her neighborhood looking in everyone’s houses.|
Nemesis|an enemy who is constantly causing problems |Kara was not happy when her nemesis won the contest.|
Neoclassical|in the manner of Ancient Greek or Romans|Neoclassical artists model their paintings off of Ancient Greek and Roman masterpieces.|
Neolithic|relating to a time known as the New Stone Age in which polished stone tools, pottery, weaving, stock rearing, and agriculture became prominent|The village dwellings are adobe style and were crafted from clay and water.|
Neolithic|the last part of the Stone Age in which agricultural and technological elements began to advance|The village is home to a Neolithic dig site where late Stone Age pieces have been discovered.|
Neologism|a new term or phrase recently added to a person or group’s vocabulary|The neologism became so popular it was added to most dictionaries.|
Neonatal|relating to a newborn baby|Positive neonatal outcomes were much more positive for babies whose mothers did not smoke during pregnancy.|
Neophyte|someone who is just learning to do something|Because I have very little computer experience, I am a neophyte when it comes to working with most software programs.|
Nepenthe|a fictional potion said to have been used by the ancient people to erase the memory of pain or sorrow|To help her chase away all of her sorrow, Polydamna gave Helen a nepenthe potion.|
Nephew|a son of one's brother or sister|My sister enjoys keeping her nephew in the afternoons and it helps me get work done as well.|
Nepotism|the act of giving opportunities to others simply because of a personal relationship |Since George is an idiot everyone knows his father hired him because of nepotism.|
Nerve|courage; steadfastness|Gathering the nerve to ask the young lady to dance, the shy wallflower ventured away from the corner and marched towards the center of the dance floor.|
Nerves|a person’s mental state or perceived source of emotional control|The anxious player’s nerves were on edge as he waited to see if he would be drafted in the first round.|
Nervous|anxious; worried|The bank teller could tell that the uneasy robber was nervous by the way his hand shook as he brandished his weapon.|
Nervously|anxiously; apprehensively|Smiling nervously, the interviewee tried not to let her anxiety show.|
Nervousness|anxiety; edginess|During dinner, the gentleman could sense his date’s nervousness as she anxiously tapped her fingers on the table.|
Nescience|unawareness or ignorance|Because of a nescience of allergic reactions, many people with allergies don’t carry the proper emergency medicines.|
Nestle|to snuggle or cuddle something|The bear cub’s mother began to nestle him closer as they drifted off to sleep.|
Net|a piece of mesh fabric used for as specific purpose (usually to catch animals or sports balls.)|Positioning the net in the water, the fisherman prepared to catch a fish with one swift swoop.|
Nether|rear; posterior|An anatomy ultrasound scan of the fetus’s nether regions showed that he is definitely all boy.|
Nettle|to cause someone to become annoyed or angry|My brother will often nettle me by reading my diary.|
Nettlesome|irritating; annoying|Asking another nettlesome question, the child irritated her mother to no end.|
Network|a system or association|Our insurance will only pay for treatment if you use a doctor that is in their network of providers.|
Neural|relating to the nervous system|Nerves in the brain of mice brains were examined to determine what kind of neural response was released after food was given.|
Neuralgia|pain in a nerve pathway|Neuralgia is a form of chronic nerve pain that is hard for doctors to understand and diagnose.|
Neurasthenic|a now obsolete psychiatric symptom that is more commonly known as chronic fatigue syndrome and is characterized by extreme mental and physical exhaustion|Early 19th century insane asylums were filled with people showing neurasthenic symptoms, simply exhausted and in need of rest.|
Neurological|related to the science of the nerves and nervous system|Neurological problems related to the brain’s nerve endings were diagnosed by the patient’s physician.|
Neurologist|a physician that deals with deals with the nervous system and the diseases that affect it|Only one neurologist was available to talk to the patient’s family after he severely injured the nerves in his hand.|
Neurology|the branch of medicine that deals with the nervous system and the diseases that affect it|The physician decided to specialize in neurology since the study of the central nervous system piqued her interest.|
Neuromuscular|relating to both the nerves and muscles|Neuromuscular damage to the spinal cord nerves and surrounding muscles left the diver unable to move.|
Neuroscience|the scientific study of the nervous system and the brain|The field of neuroscience is fairly new, with the study of the brain and the body’s still being rather contemporary.|
Neurotic|overly anxious; unstable|Sally is a neurotic person who is often moody.|
Neutral|unbiased; impartial|Being neutral in the matter, I refused to take sides with either my brother or my sister.|
Neutrality|the state or quality of being neutral; state of taking no part on either side|Neutrality was impossible when choosing to write a persuasive speech.|
Neutralize|to make unsuccessful or ineffective|A glass of milk will help neutralize the spicy contents in my stomach.|
Neutron|a particle in a nucleus, made of quarks, that lacks an electric charge and has a mass comparable to the mass of a proton|Unlike a proton which has a positive charge, a neutron doesn’t have any charge.|
Nevertheless|yet; however|A wage assignment was issued; nevertheless, a payment has not been made.|
New-hire|an employee who was recently hired for a job|The manager requested that the new-hire take a drug test before reporting to his newly assigned post.|
Newfangled|contemporary; modern|Newfangled cell phone cameras have all put replaced the handheld Polaroids of the past.|
Newness|the quality of being new or original|The shiny diamond’s newness quickly wore off, and the woman returned the impulsive purchase to the jeweler.|
Newscast|a news broadcast|Expressing their condolences beforehand, reporters on the ten o’clock newscast confirmed that remains of the missing scuba diver had been discovered.|
Newton|the Standard International unit of force|Force is a quantity that is measured by a metric unit known as a newton.|
Next|following; subsequent|The next day, the oracle’s prediction came true when a golden-haired warrior appeared to claim the throne.|
Nexus|the focal place or point|In our town, the nexus of the art world is the museum district.|
Nibble|to take small bites|As he continued to nibble on the small piece of cheese, the mouse did not see the sneaky cat coming up behind him.|
Nicely|suitably; adequately|The colors of the tenant’s new furniture blends in nicely with the apartments neutral walls.|
Nicety|accuracy or precision|The nicety of her spelling allowed her to win both the local and state spelling bees.|
Niche|a unique field or market|With so many cupcakes stores open, it is hard to find a competitive niche in that market.|
Nick|a small chip or groove|A small nick in the wood was the only flaw in the bedroom suite.|
Nickname|an alias or alternate name that someone uses instead of their real name|Because he has the same name as hid dad, Jerry goes by the nickname Junior.|
Niece|the daughter of one’s sister or brother|My brother and sister-in-law want to have a boy, but I am secretly hoping for a niece.|
Niggardly|miserly; extremely stingy|Even though the niggardly old man was worth millions, he still buried his wife in the cheapest casket available.|
Niggle|to cause minor but continuous irritation or anxiety|Something decided to niggle at me for the duration of the day, but even though it continued to bother me I couldn’t remember what it was.|
Nightmare|a very terrifying or upsetting situation|The bride’s dream wedding quickly turned into a nightmare after the groom ran away from the altar.|
Nihilism|the idea that societal rules are worthless and should be eliminated|The rebels urged the people to grab hold of nihilism and remove all government officials from office.|
Nil|nothing, zero, nonexistent|With only five of us and over a hundred of the enemy, our chances of emerging victorious in this battle are nil.|
Nimble|quick in action or comprehension|The overweight police officer could not catch the nimble suspect.|
Nimbus|a dark grey rain cloud|Looking up at the dark nimbus, Hector wondered how long it would be before it started to rain.|
Nimiety|a quantity that is in excess of what’s appropriate|A nimiety of food was spread over the tables and was way more than any one group of people could eat.|
Nincompoop|a foolish person who is considered dumb|Harold always behaves like a nincompoop, running around making faces at others trying to do their work.|
Nitpick|to correct minutiae or find fault in unimportant details|Does anyone else notice how judges will nitpick about the littlest mistakes on competition shows?|
Niveous|snowy; white like snow|After the snowstorm, the niveous landscape was as white as snow.|
Nix|to cancel, end, or reject|Over time, it became painfully clear that the smartest choice was to nix the partnership and dissolve the business.|
Nobility|the people of a society who are privileged and of high rank or title|The nobility ate with the King and Queen during the huge feast.|
